Id,Id2,Geography,Total,hasacomputer,dialupinternet,broadbandinternet,withoutaninternet,nocomputer
0500000US01001,1001,"Autauga County, Alabama",21054,18145,70,16055,2020,2909
0500000US01003,1003,"Baldwin County, Alabama",76133,66174,604,56510,9060,9959
0500000US01005,1005,"Barbour County, Alabama",9191,6747,132,5187,1428,2444
0500000US01007,1007,"Bibb County, Alabama",6916,5176,21,4270,885,1740
0500000US01009,1009,"Blount County, Alabama",20690,16175,275,13499,2401,4515
0500000US01011,1011,"Bullock County, Alabama",3670,2357,22,1760,575,1313
0500000US01013,1013,"Butler County, Alabama",7050,4818,100,4002,716,2232
0500000US01015,1015,"Calhoun County, Alabama",45099,37406,247,31619,5540,7693
0500000US01017,1017,"Chambers County, Alabama",13694,9951,88,8460,1403,3743
0500000US01019,1019,"Cherokee County, Alabama",10795,8576,43,7244,1289,2219
0500000US01021,1021,"Chilton County, Alabama",16768,12374,171,9434,2769,4394
0500000US01023,1023,"Choctaw County, Alabama",5463,3847,58,2845,944,1616
0500000US01025,1025,"Clarke County, Alabama",9602,5635,93,4453,1089,3967
0500000US01027,1027,"Clay County, Alabama",5338,4113,16,3490,607,1225
0500000US01029,1029,"Cleburne County, Alabama",5773,4264,61,3315,888,1509
0500000US01031,1031,"Coffee County, Alabama",19620,16494,124,14504,1866,3126
0500000US01033,1033,"Colbert County, Alabama",21983,17657,172,14363,3122,4326
0500000US01035,1035,"Conecuh County, Alabama",4716,2430,27,1920,483,2286
0500000US01037,1037,"Coosa County, Alabama",4204,2940,32,2396,512,1264
0500000US01039,1039,"Covington County, Alabama",15285,11329,129,9810,1390,3956
0500000US01041,1041,"Crenshaw County, Alabama",5358,3778,26,3017,735,1580
0500000US01043,1043,"Cullman County, Alabama",31097,24529,378,20077,4074,6568
0500000US01045,1045,"Dale County, Alabama",18825,15298,154,12956,2188,3527
0500000US01047,1047,"Dallas County, Alabama",16487,11401,129,9315,1957,5086
0500000US01049,1049,"DeKalb County, Alabama",25482,19196,187,15403,3606,6286
0500000US01051,1051,"Elmore County, Alabama",29115,25237,129,22479,2629,3878
0500000US01053,1053,"Escambia County, Alabama",13226,8386,123,7170,1093,4840
0500000US01055,1055,"Etowah County, Alabama",39061,31505,237,26357,4911,7556
0500000US01057,1057,"Fayette County, Alabama",6955,5130,15,4405,710,1825
0500000US01059,1059,"Franklin County, Alabama",11533,8563,123,6865,1575,2970
0500000US01061,1061,"Geneva County, Alabama",10693,8443,202,6806,1435,2250
0500000US01063,1063,"Greene County, Alabama",3025,1688,41,1238,409,1337
0500000US01065,1065,"Hale County, Alabama",5664,3644,26,2812,806,2020
0500000US01067,1067,"Henry County, Alabama",6727,5238,92,4484,662,1489
0500000US01069,1069,"Houston County, Alabama",39560,30928,656,26473,3799,8632
0500000US01071,1071,"Jackson County, Alabama",20368,15281,139,12601,2541,5087
0500000US01073,1073,"Jefferson County, Alabama",261390,220690,924,188849,30917,40700
0500000US01075,1075,"Lamar County, Alabama",6019,4409,65,3473,871,1610
0500000US01077,1077,"Lauderdale County, Alabama",38634,30443,364,24938,5141,8191
0500000US01079,1079,"Lawrence County, Alabama",13056,9736,231,7160,2345,3320
0500000US01081,1081,"Lee County, Alabama",59001,52091,190,45831,6070,6910
0500000US01083,1083,"Limestone County, Alabama",32386,26830,214,23323,3293,5556
0500000US01085,1085,"Lowndes County, Alabama",4309,2764,65,1960,739,1545
0500000US01087,1087,"Macon County, Alabama",7852,5537,69,4013,1455,2315
0500000US01089,1089,"Madison County, Alabama",142253,127315,598,115107,11610,14938
0500000US01091,1091,"Marengo County, Alabama",7975,5335,124,3968,1243,2640
0500000US01093,1093,"Marion County, Alabama",12453,9493,47,8057,1389,2960
0500000US01095,1095,"Marshall County, Alabama",34588,27612,155,24029,3428,6976
0500000US01097,1097,"Mobile County, Alabama",153794,123108,699,105466,16943,30686
0500000US01099,1099,"Monroe County, Alabama",8207,4084,25,3148,911,4123
0500000US01101,1101,"Montgomery County, Alabama",89776,75737,258,67042,8437,14039
0500000US01103,1103,"Morgan County, Alabama",45904,37992,498,31925,5569,7912
0500000US01105,1105,"Perry County, Alabama",3039,1655,38,1177,440,1384
0500000US01107,1107,"Pickens County, Alabama",7620,5407,64,4535,808,2213
0500000US01109,1109,"Pike County, Alabama",12284,8805,248,7363,1194,3479
0500000US01111,1111,"Randolph County, Alabama",8867,6811,173,5693,945,2056
0500000US01113,1113,"Russell County, Alabama",22690,18197,209,14197,3791,4493
0500000US01115,1115,"St. Clair County, Alabama",32486,27537,298,23339,3900,4949
0500000US01117,1117,"Shelby County, Alabama",76868,71009,279,64638,6092,5859
0500000US01119,1119,"Sumter County, Alabama",5073,3285,62,2516,707,1788
0500000US01121,1121,"Talladega County, Alabama",31651,24854,254,20511,4089,6797
0500000US01123,1123,"Tallapoosa County, Alabama",16369,12653,62,11019,1572,3716
0500000US01125,1125,"Tuscaloosa County, Alabama",71507,60229,163,53612,6454,11278
0500000US01127,1127,"Walker County, Alabama",25143,19370,244,15579,3547,5773
0500000US01129,1129,"Washington County, Alabama",6001,4462,38,3206,1218,1539
0500000US01131,1131,"Wilcox County, Alabama",3841,2319,151,1594,574,1522
0500000US01133,1133,"Winston County, Alabama",9439,6846,119,5214,1513,2593
0500000US02013,2013,"Aleutians East Borough, Alaska",812,693,0,551,142,119
0500000US02016,2016,"Aleutians West Census Area, Alaska",1218,1118,2,900,216,100
0500000US02020,2020,"Anchorage Municipality, Alaska",106012,100312,413,92255,7644,5700
0500000US02050,2050,"Bethel Census Area, Alaska",4524,3708,1,3165,542,816
0500000US02060,2060,"Bristol Bay Borough, Alaska",358,327,7,291,29,31
0500000US02068,2068,"Denali Borough, Alaska",678,644,0,603,41,34
0500000US02070,2070,"Dillingham Census Area, Alaska",1405,1146,2,1008,136,259
0500000US02090,2090,"Fairbanks North Star Borough, Alaska",36396,34149,231,29744,4174,2247
0500000US02100,2100,"Haines Borough, Alaska",1087,1016,19,839,158,71
0500000US02105,2105,"Hoonah-Angoon Census Area, Alaska",802,670,2,578,90,132
0500000US02110,2110,"Juneau City and Borough, Alaska",12273,11600,76,10713,811,673
0500000US02122,2122,"Kenai Peninsula Borough, Alaska",21779,19472,337,16367,2768,2307
0500000US02130,2130,"Ketchikan Gateway Borough, Alaska",5270,4807,26,4255,526,463
0500000US02150,2150,"Kodiak Island Borough, Alaska",4538,4084,5,3727,352,454
0500000US02158,2158,"Kusilvak Census Area, Alaska",1752,1340,0,1011,329,412
0500000US02164,2164,"Lake and Peninsula Borough, Alaska",408,338,1,245,92,70
0500000US02170,2170,"Matanuska-Susitna Borough, Alaska",30613,28582,190,26020,2372,2031
0500000US02180,2180,"Nome Census Area, Alaska",2897,2477,2,1948,527,420
0500000US02185,2185,"North Slope Borough, Alaska",2041,1723,10,1382,331,318
0500000US02188,2188,"Northwest Arctic Borough, Alaska",1849,1478,0,1223,255,371
0500000US02195,2195,"Petersburg Borough, Alaska",1255,1131,4,953,174,124
0500000US02198,2198,"Prince of Wales-Hyder Census Area, Alaska",2315,1993,5,1570,418,322
0500000US02220,2220,"Sitka City and Borough, Alaska",3545,3265,17,2844,404,280
0500000US02230,2230,"Skagway Municipality, Alaska",423,407,1,352,54,16
0500000US02240,2240,"Southeast Fairbanks Census Area, Alaska",2139,1897,11,1603,283,242
0500000US02261,2261,"Valdez-Cordova Census Area, Alaska",2849,2630,48,2267,315,219
0500000US02275,2275,"Wrangell City and Borough, Alaska",1084,916,10,807,99,168
0500000US02282,2282,"Yakutat City and Borough, Alaska",255,227,3,177,47,28
0500000US02290,2290,"Yukon-Koyukuk Census Area, Alaska",1959,1275,4,852,419,684
0500000US04001,4001,"Apache County, Arizona",19530,10703,183,7374,3146,8827
0500000US04003,4003,"Cochise County, Arizona",49160,41975,262,37198,4515,7185
0500000US04005,4005,"Coconino County, Arizona",47588,41660,245,35580,5835,5928
0500000US04007,4007,"Gila County, Arizona",21585,17067,155,13042,3870,4518
0500000US04009,4009,"Graham County, Arizona",10976,9213,31,7615,1567,1763
0500000US04011,4011,"Greenlee County, Arizona",3364,2968,0,2544,424,396
0500000US04012,4012,"La Paz County, Arizona",8798,6483,93,5074,1316,2315
0500000US04013,4013,"Maricopa County, Arizona",1489533,1338280,6375,1210358,121547,151253
0500000US04015,4015,"Mohave County, Arizona",83902,71132,751,63345,7036,12770
0500000US04017,4017,"Navajo County, Arizona",34251,25125,245,20098,4782,9126
0500000US04019,4019,"Pima County, Arizona",398530,356500,2359,319303,34838,42030
0500000US04021,4021,"Pinal County, Arizona",133513,115418,713,102296,12409,18095
0500000US04023,4023,"Santa Cruz County, Arizona",15568,12416,125,10444,1847,3152
0500000US04025,4025,"Yavapai County, Arizona",94343,83353,729,73367,9257,10990
0500000US04027,4027,"Yuma County, Arizona",71670,58026,569,52026,5431,13644
0500000US05001,5001,"Arkansas County, Arkansas",7692,6093,45,4577,1471,1599
0500000US05003,5003,"Ashley County, Arkansas",8182,6180,50,4795,1335,2002
0500000US05005,5005,"Baxter County, Arkansas",18398,14957,300,12556,2101,3441
0500000US05007,5007,"Benton County, Arkansas",90906,82043,336,53920,27787,8863
0500000US05009,5009,"Boone County, Arkansas",14887,12239,134,10914,1191,2648
0500000US05011,5011,"Bradley County, Arkansas",4566,3306,21,2504,781,1260
0500000US05013,5013,"Calhoun County, Arkansas",2061,1510,51,1081,378,551
0500000US05015,5015,"Carroll County, Arkansas",10832,8713,191,6711,1811,2119
0500000US05017,5017,"Chicot County, Arkansas",4323,3070,40,2398,632,1253
0500000US05019,5019,"Clark County, Arkansas",8820,6752,35,5413,1304,2068
0500000US05021,5021,"Clay County, Arkansas",6428,4709,22,3768,919,1719
0500000US05023,5023,"Cleburne County, Arkansas",10646,8441,86,7070,1285,2205
0500000US05025,5025,"Cleveland County, Arkansas",3292,2587,59,1735,793,705
0500000US05027,5027,"Columbia County, Arkansas",9337,6800,73,5350,1377,2537
0500000US05029,5029,"Conway County, Arkansas",8185,6073,86,4357,1630,2112
0500000US05031,5031,"Craighead County, Arkansas",39838,34914,66,30744,4104,4924
0500000US05033,5033,"Crawford County, Arkansas",23870,19516,278,16151,3087,4354
0500000US05035,5035,"Crittenden County, Arkansas",18659,14559,67,12398,2094,4100
0500000US05037,5037,"Cross County, Arkansas",6726,4921,31,4136,754,1805
0500000US05039,5039,"Dallas County, Arkansas",3144,2275,21,1642,612,869
0500000US05041,5041,"Desha County, Arkansas",5230,3822,61,2366,1395,1408
0500000US05043,5043,"Drew County, Arkansas",7038,5510,94,4401,1015,1528
0500000US05045,5045,"Faulkner County, Arkansas",43835,38638,337,32452,5849,5197
0500000US05047,5047,"Franklin County, Arkansas",6862,4942,114,3620,1208,1920
0500000US05049,5049,"Fulton County, Arkansas",5117,4181,0,3093,1088,936
0500000US05051,5051,"Garland County, Arkansas",40062,33790,388,28916,4486,6272
0500000US05053,5053,"Grant County, Arkansas",6851,5962,57,4668,1237,889
0500000US05055,5055,"Greene County, Arkansas",16821,14206,65,12008,2133,2615
0500000US05057,5057,"Hempstead County, Arkansas",7930,5811,70,4803,938,2119
0500000US05059,5059,"Hot Spring County, Arkansas",12291,9938,195,7580,2163,2353
0500000US05061,5061,"Howard County, Arkansas",5042,3884,31,3019,834,1158
0500000US05063,5063,"Independence County, Arkansas",14288,11493,208,8894,2391,2795
0500000US05065,5065,"Izard County, Arkansas",5189,4243,72,2942,1229,946
0500000US05067,5067,"Jackson County, Arkansas",6179,4365,39,3480,846,1814
0500000US05069,5069,"Jefferson County, Arkansas",27377,21639,208,14610,6821,5738
0500000US05071,5071,"Johnson County, Arkansas",9900,7463,60,5769,1634,2437
0500000US05073,5073,"Lafayette County, Arkansas",2860,1833,44,1404,385,1027
0500000US05075,5075,"Lawrence County, Arkansas",6584,4911,48,3849,1014,1673
0500000US05077,5077,"Lee County, Arkansas",3541,2369,41,1579,749,1172
0500000US05079,5079,"Lincoln County, Arkansas",3928,2859,22,2169,668,1069
0500000US05081,5081,"Little River County, Arkansas",5300,4151,112,3232,807,1149
0500000US05083,5083,"Logan County, Arkansas",8269,6560,80,5387,1093,1709
0500000US05085,5085,"Lonoke County, Arkansas",26281,22562,158,19413,2991,3719
0500000US05087,5087,"Madison County, Arkansas",6190,4618,136,3542,940,1572
0500000US05089,5089,"Marion County, Arkansas",6663,5371,48,4611,712,1292
0500000US05091,5091,"Miller County, Arkansas",17020,14097,183,11817,2097,2923
0500000US05093,5093,"Mississippi County, Arkansas",17238,13421,71,10301,3049,3817
0500000US05095,5095,"Monroe County, Arkansas",3328,2225,25,1534,666,1103
0500000US05097,5097,"Montgomery County, Arkansas",3855,2764,29,2171,564,1091
0500000US05099,5099,"Nevada County, Arkansas",3452,2199,105,1612,482,1253
0500000US05101,5101,"Newton County, Arkansas",3152,2262,86,1723,453,890
0500000US05103,5103,"Ouachita County, Arkansas",10016,6645,127,5284,1234,3371
0500000US05105,5105,"Perry County, Arkansas",3692,2926,38,2286,602,766
0500000US05107,5107,"Phillips County, Arkansas",7823,5374,22,4308,1044,2449
0500000US05109,5109,"Pike County, Arkansas",4313,3222,38,2472,712,1091
0500000US05111,5111,"Poinsett County, Arkansas",9483,7275,53,6092,1130,2208
0500000US05113,5113,"Polk County, Arkansas",8058,6231,137,4740,1354,1827
0500000US05115,5115,"Pope County, Arkansas",23147,19259,203,15644,3412,3888
0500000US05117,5117,"Prairie County, Arkansas",3920,2841,23,1898,920,1079
0500000US05119,5119,"Pulaski County, Arkansas",155435,130910,935,112050,17925,24525
0500000US05121,5121,"Randolph County, Arkansas",7339,5458,98,4444,916,1881
0500000US05123,5123,"St. Francis County, Arkansas",9325,6363,54,4437,1872,2962
0500000US05125,5125,"Saline County, Arkansas",43314,38002,217,33342,4443,5312
0500000US05127,5127,"Scott County, Arkansas",3972,2895,32,2069,794,1077
0500000US05129,5129,"Searcy County, Arkansas",3336,2429,98,1747,584,907
0500000US05131,5131,"Sebastian County, Arkansas",50301,40491,180,34301,6010,9810
0500000US05133,5133,"Sevier County, Arkansas",5984,4625,53,3898,674,1359
0500000US05135,5135,"Sharp County, Arkansas",7296,5570,40,4235,1295,1726
0500000US05137,5137,"Stone County, Arkansas",4910,3686,84,2463,1139,1224
0500000US05139,5139,"Union County, Arkansas",16189,11560,58,9560,1942,4629
0500000US05141,5141,"Van Buren County, Arkansas",6867,5264,100,3971,1193,1603
0500000US05143,5143,"Washington County, Arkansas",84460,75835,443,63335,12057,8625
0500000US05145,5145,"White County, Arkansas",29217,24225,157,20178,3890,4992
0500000US05147,5147,"Woodruff County, Arkansas",2874,1756,14,1453,289,1118
0500000US05149,5149,"Yell County, Arkansas",7555,5511,69,4574,868,2044
0500000US06001,6001,"Alameda County, California",569070,526319,2110,485617,38592,42751
0500000US06003,6003,"Alpine County, California",304,278,0,266,12,26
0500000US06005,6005,"Amador County, California",14185,12315,141,11173,1001,1870
0500000US06007,6007,"Butte County, California",86167,76885,745,69327,6813,9282
0500000US06009,6009,"Calaveras County, California",17812,15019,487,13278,1254,2793
0500000US06011,6011,"Colusa County, California",7047,5799,65,5222,512,1248
0500000US06013,6013,"Contra Costa County, California",389597,363986,1525,341991,20470,25611
0500000US06015,6015,"Del Norte County, California",9683,8234,36,7042,1156,1449
0500000US06017,6017,"El Dorado County, California",68084,62627,629,56699,5299,5457
0500000US06019,6019,"Fresno County, California",301824,257509,2158,223625,31726,44315
0500000US06021,6021,"Glenn County, California",9936,8013,80,6342,1591,1923
0500000US06023,6023,"Humboldt County, California",53966,47750,349,42606,4795,6216
0500000US06025,6025,"Imperial County, California",45198,37310,275,31252,5783,7888
0500000US06027,6027,"Inyo County, California",8026,7013,29,6053,931,1013
0500000US06029,6029,"Kern County, California",264993,219896,1878,194111,23907,45097
0500000US06031,6031,"Kings County, California",42349,36207,235,31027,4945,6142
0500000US06033,6033,"Lake County, California",26327,21403,223,18410,2770,4924
0500000US06035,6035,"Lassen County, California",9441,7775,147,6845,783,1666
0500000US06037,6037,"Los Angeles County, California",3295198,2923682,15974,2615882,291826,371516
0500000US06039,6039,"Madera County, California",44458,37454,301,31652,5501,7004
0500000US06041,6041,"Marin County, California",104846,97630,369,92846,4415,7216
0500000US06043,6043,"Mariposa County, California",7434,6160,162,5251,747,1274
0500000US06045,6045,"Mendocino County, California",34182,28826,625,25031,3170,5356
0500000US06047,6047,"Merced County, California",79261,68763,680,58966,9117,10498
0500000US06049,6049,"Modoc County, California",3638,2743,10,2442,291,895
0500000US06051,6051,"Mono County, California",4899,4338,149,3525,664,561
0500000US06053,6053,"Monterey County, California",125939,107713,705,97876,9132,18226
0500000US06055,6055,"Napa County, California",49044,45107,263,41833,3011,3937
0500000US06057,6057,"Nevada County, California",40386,36326,454,33043,2829,4060
0500000US06059,6059,"Orange County, California",1024976,957540,5583,895737,56220,67436
0500000US06061,6061,"Placer County, California",138564,129125,803,120135,8187,9439
0500000US06063,6063,"Plumas County, California",8287,6849,141,5796,912,1438
0500000US06065,6065,"Riverside County, California",711724,641948,3792,583612,54544,69776
0500000US06067,6067,"Sacramento County, California",532050,488003,2693,438491,46819,44047
0500000US06069,6069,"San Benito County, California",17440,16230,96,15070,1064,1210
0500000US06071,6071,"San Bernardino County, California",623642,557032,2787,490914,63331,66610
0500000US06073,6073,"San Diego County, California",1111739,1030723,3799,962033,64891,81016
0500000US06075,6075,"San Francisco County, California",358772,325603,1432,301600,22571,33169
0500000US06077,6077,"San Joaquin County, California",223808,193348,1702,172109,19537,30460
0500000US06079,6079,"San Luis Obispo County, California",105044,96436,851,88910,6675,8608
0500000US06081,6081,"San Mateo County, California",261796,245268,919,230217,14132,16528
0500000US06083,6083,"Santa Barbara County, California",144015,128819,1061,117841,9917,15196
0500000US06085,6085,"Santa Clara County, California",630451,595362,2665,561340,31357,35089
0500000US06087,6087,"Santa Cruz County, California",95536,86839,415,80737,5687,8697
0500000US06089,6089,"Shasta County, California",70486,60324,616,52888,6820,10162
0500000US06091,6091,"Sierra County, California",1208,916,4,833,79,292
0500000US06093,6093,"Siskiyou County, California",19018,15819,268,14121,1430,3199
0500000US06095,6095,"Solano County, California",147352,134918,583,126246,8089,12434
0500000US06097,6097,"Sonoma County, California",190058,174535,1248,160697,12590,15523
0500000US06099,6099,"Stanislaus County, California",171324,149824,874,134645,14305,21500
0500000US06101,6101,"Sutter County, California",32188,28068,167,25164,2737,4120
0500000US06103,6103,"Tehama County, California",23712,19494,247,16417,2830,4218
0500000US06105,6105,"Trinity County, California",5462,4454,93,3477,884,1008
0500000US06107,6107,"Tulare County, California",135144,109380,1023,92431,15926,25764
0500000US06109,6109,"Tuolumne County, California",22267,19230,254,16826,2150,3037
0500000US06111,6111,"Ventura County, California",270046,245509,852,228466,16191,24537
0500000US06113,6113,"Yolo County, California",72845,66653,404,60555,5694,6192
0500000US06115,6115,"Yuba County, California",25880,23164,151,20608,2405,2716
0500000US08001,8001,"Adams County, Colorado",162508,148153,925,129002,18226,14355
0500000US08003,8003,"Alamosa County, Colorado",6049,4929,73,4010,846,1120
0500000US08005,8005,"Arapahoe County, Colorado",235263,221108,1765,202360,16983,14155
0500000US08007,8007,"Archuleta County, Colorado",5553,4971,63,4379,529,582
0500000US08009,8009,"Baca County, Colorado",1603,1300,6,1105,189,303
0500000US08011,8011,"Bent County, Colorado",1760,1406,25,1238,143,354
0500000US08013,8013,"Boulder County, Colorado",125026,119188,495,110336,8357,5838
0500000US08014,8014,"Broomfield County, Colorado",25938,24915,90,23585,1240,1023
0500000US08015,8015,"Chaffee County, Colorado",7900,7023,69,6329,625,877
0500000US08017,8017,"Cheyenne County, Colorado",776,646,9,584,53,130
0500000US08019,8019,"Clear Creek County, Colorado",4374,4076,66,3542,468,298
0500000US08021,8021,"Conejos County, Colorado",2992,2066,38,1804,224,926
0500000US08023,8023,"Costilla County, Colorado",1568,970,17,805,148,598
0500000US08025,8025,"Crowley County, Colorado",1215,1029,20,921,88,186
0500000US08027,8027,"Custer County, Colorado",2093,1865,10,1584,271,228
0500000US08029,8029,"Delta County, Colorado",12119,9966,179,8436,1351,2153
0500000US08031,8031,"Denver County, Colorado",287262,259036,1462,232171,25403,28226
0500000US08033,8033,"Dolores County, Colorado",707,570,24,451,95,137
0500000US08035,8035,"Douglas County, Colorado",113799,111260,431,107411,3418,2539
0500000US08037,8037,"Eagle County, Colorado",17765,16956,128,15389,1439,809
0500000US08039,8039,"Elbert County, Colorado",8866,8386,55,7791,540,480
0500000US08041,8041,"El Paso County, Colorado",249745,232680,1501,218159,13020,17065
0500000US08043,8043,"Fremont County, Colorado",16762,14346,212,12622,1512,2416
0500000US08045,8045,"Garfield County, Colorado",21055,19475,277,17209,1989,1580
0500000US08047,8047,"Gilpin County, Colorado",2603,2419,17,2104,298,184
0500000US08049,8049,"Grand County, Colorado",5724,5152,5,4922,225,572
0500000US08051,8051,"Gunnison County, Colorado",6495,5956,93,5170,693,539
0500000US08053,8053,"Hinsdale County, Colorado",368,330,3,250,77,38
0500000US08055,8055,"Huerfano County, Colorado",3173,2445,94,1906,445,728
0500000US08057,8057,"Jackson County, Colorado",597,496,4,423,69,101
0500000US08059,8059,"Jefferson County, Colorado",227805,212944,1619,197050,14275,14861
0500000US08061,8061,"Kiowa County, Colorado",576,481,0,440,41,95
0500000US08063,8063,"Kit Carson County, Colorado",2995,2470,13,2180,277,525
0500000US08065,8065,"Lake County, Colorado",3324,2891,29,2520,342,433
0500000US08067,8067,"La Plata County, Colorado",21818,19589,246,16747,2596,2229
0500000US08069,8069,"Larimer County, Colorado",130502,123408,899,112686,9823,7094
0500000US08071,8071,"Las Animas County, Colorado",6327,4843,97,4072,674,1484
0500000US08073,8073,"Lincoln County, Colorado",1477,1249,33,1101,115,228
0500000US08075,8075,"Logan County, Colorado",8151,6855,87,6158,610,1296
0500000US08077,8077,"Mesa County, Colorado",60562,54083,521,49679,3883,6479
0500000US08079,8079,"Mineral County, Colorado",404,360,3,316,41,44
0500000US08081,8081,"Moffat County, Colorado",5103,4390,30,3871,489,713
0500000US08083,8083,"Montezuma County, Colorado",10520,8868,110,7065,1693,1652
0500000US08085,8085,"Montrose County, Colorado",16951,14035,187,12169,1679,2916
0500000US08087,8087,"Morgan County, Colorado",10599,8813,80,7851,882,1786
0500000US08089,8089,"Otero County, Colorado",7490,6209,25,5332,852,1281
0500000US08091,8091,"Ouray County, Colorado",2204,2035,29,1794,212,169
0500000US08093,8093,"Park County, Colorado",7389,6740,35,6024,681,649
0500000US08095,8095,"Phillips County, Colorado",1696,1512,21,1311,180,184
0500000US08097,8097,"Pitkin County, Colorado",7340,6951,123,6442,386,389
0500000US08099,8099,"Prowers County, Colorado",4913,4009,3,3634,372,904
0500000US08101,8101,"Pueblo County, Colorado",63489,53332,638,44014,8680,10157
0500000US08103,8103,"Rio Blanco County, Colorado",2417,2042,16,1732,294,375
0500000US08105,8105,"Rio Grande County, Colorado",4750,3544,56,2965,523,1206
0500000US08107,8107,"Routt County, Colorado",9478,8834,33,8372,429,644
0500000US08109,8109,"Saguache County, Colorado",2626,2179,26,1757,396,447
0500000US08111,8111,"San Juan County, Colorado",255,226,7,201,18,29
0500000US08113,8113,"San Miguel County, Colorado",3301,3107,28,2614,465,194
0500000US08115,8115,"Sedgwick County, Colorado",998,796,26,635,135,202
0500000US08117,8117,"Summit County, Colorado",9455,9129,52,7749,1328,326
0500000US08119,8119,"Teller County, Colorado",10076,9396,115,8690,591,680
0500000US08121,8121,"Washington County, Colorado",2012,1703,27,1467,209,309
0500000US08123,8123,"Weld County, Colorado",99817,90552,744,80306,9502,9265
0500000US08125,8125,"Yuma County, Colorado",4053,3199,51,2717,431,854
0500000US09001,9001,"Fairfield County, Connecticut",337678,306421,1186,286383,18852,31257
0500000US09003,9003,"Hartford County, Connecticut",348871,304388,1753,277900,24735,44483
0500000US09005,9005,"Litchfield County, Connecticut",74605,66442,510,61853,4079,8163
0500000US09007,9007,"Middlesex County, Connecticut",66599,59484,340,55376,3768,7115
0500000US09009,9009,"New Haven County, Connecticut",327402,280568,1609,255199,23760,46834
0500000US09011,9011,"New London County, Connecticut",107193,95126,482,88497,6147,12067
0500000US09013,9013,"Tolland County, Connecticut",54878,50250,291,46742,3217,4628
0500000US09015,9015,"Windham County, Connecticut",44529,38875,316,34846,3713,5654
0500000US10001,10001,"Kent County, Delaware",63381,56622,397,50952,5273,6759
0500000US10003,10003,"New Castle County, Delaware",202654,180265,883,162361,17021,22389
0500000US10005,10005,"Sussex County, Delaware",86322,74467,553,64930,8984,11855
0500000US11001,11001,"District of Columbia, District of Columbia",277985,245069,890,214031,30148,32916
0500000US12001,12001,"Alachua County, Florida",97485,86716,516,78792,7408,10769
0500000US12003,12003,"Baker County, Florida",8299,7004,98,5815,1091,1295
0500000US12005,12005,"Bay County, Florida",68667,60824,311,54800,5713,7843
0500000US12007,12007,"Bradford County, Florida",8980,6535,78,5773,684,2445
0500000US12009,12009,"Brevard County, Florida",227223,204249,1265,187515,15469,22974
0500000US12011,12011,"Broward County, Florida",675828,609911,2786,542977,64148,65917
0500000US12013,12013,"Calhoun County, Florida",4581,3405,42,2706,657,1176
0500000US12015,12015,"Charlotte County, Florida",74884,66158,705,59373,6080,8726
0500000US12017,12017,"Citrus County, Florida",62488,53975,411,48499,5065,8513
0500000US12019,12019,"Clay County, Florida",71939,67007,550,61601,4856,4932
0500000US12021,12021,"Collier County, Florida",138131,125935,969,111529,13437,12196
0500000US12023,12023,"Columbia County, Florida",24722,21126,158,17960,3008,3596
0500000US12027,12027,"DeSoto County, Florida",11744,7100,108,5821,1171,4644
0500000US12029,12029,"Dixie County, Florida",6431,4470,118,2819,1533,1961
0500000US12031,12031,"Duval County, Florida",347783,304145,1587,270653,31905,43638
0500000US12033,12033,"Escambia County, Florida",117836,104095,347,94106,9642,13741
0500000US12035,12035,"Flagler County, Florida",39433,35171,288,30878,4005,4262
0500000US12037,12037,"Franklin County, Florida",4327,3394,63,2975,356,933
0500000US12039,12039,"Gadsden County, Florida",17310,12340,51,9831,2458,4970
0500000US12041,12041,"Gilchrist County, Florida",6399,5002,24,3966,1012,1397
0500000US12043,12043,"Glades County, Florida",4297,2884,62,2078,744,1413
0500000US12045,12045,"Gulf County, Florida",5295,4343,56,3976,311,952
0500000US12047,12047,"Hamilton County, Florida",4551,3489,113,2785,591,1062
0500000US12049,12049,"Hardee County, Florida",7718,5228,158,4234,836,2490
0500000US12051,12051,"Hendry County, Florida",12098,8756,25,7332,1399,3342
0500000US12053,12053,"Hernando County, Florida",72234,63265,468,56533,6264,8969
0500000US12055,12055,"Highlands County, Florida",41350,32260,683,27715,3862,9090
0500000US12057,12057,"Hillsborough County, Florida",505845,456180,1501,413207,41472,49665
0500000US12059,12059,"Holmes County, Florida",7019,5310,100,4571,639,1709
0500000US12061,12061,"Indian River County, Florida",57911,49572,403,45204,3965,8339
0500000US12063,12063,"Jackson County, Florida",17041,12534,119,10880,1535,4507
0500000US12065,12065,"Jefferson County, Florida",5702,4592,103,3751,738,1110
0500000US12067,12067,"Lafayette County, Florida",2193,1703,12,1458,233,490
0500000US12069,12069,"Lake County, Florida",127441,112352,1151,101798,9403,15089
0500000US12071,12071,"Lee County, Florida",264325,237957,3000,209384,25573,26368
0500000US12073,12073,"Leon County, Florida",112373,105077,510,94254,10313,7296
0500000US12075,12075,"Levy County, Florida",15806,12598,197,9335,3066,3208
0500000US12077,12077,"Liberty County, Florida",2325,1773,28,1359,386,552
0500000US12079,12079,"Madison County, Florida",6743,4769,83,3815,871,1974
0500000US12081,12081,"Manatee County, Florida",140255,124944,574,108021,16349,15311
0500000US12083,12083,"Marion County, Florida",134747,112570,1631,99922,11017,22177
0500000US12085,12085,"Martin County, Florida",63497,56815,195,51517,5103,6682
0500000US12086,12086,"Miami-Dade County, Florida",858289,730540,3348,622432,104760,127749
0500000US12087,12087,"Monroe County, Florida",30198,26818,66,23168,3584,3380
0500000US12089,12089,"Nassau County, Florida",30454,27657,424,24516,2717,2797
0500000US12091,12091,"Okaloosa County, Florida",76574,68718,370,61186,7162,7856
0500000US12093,12093,"Okeechobee County, Florida",13333,10281,127,7693,2461,3052
0500000US12095,12095,"Orange County, Florida",451960,415037,1384,374294,39359,36923
0500000US12097,12097,"Osceola County, Florida",96250,78242,563,69084,8595,18008
0500000US12099,12099,"Palm Beach County, Florida",543591,485139,2836,436875,45428,58452
0500000US12101,12101,"Pasco County, Florida",195818,170356,1011,152373,16972,25462
0500000US12103,12103,"Pinellas County, Florida",406871,351590,1857,316677,33056,55281
0500000US12105,12105,"Polk County, Florida",226604,188980,1329,145706,41945,37624
0500000US12107,12107,"Putnam County, Florida",27951,21228,353,17403,3472,6723
0500000US12109,12109,"St. Johns County, Florida",83744,77505,448,71116,5941,6239
0500000US12111,12111,"St. Lucie County, Florida",110043,96066,708,86651,8707,13977
0500000US12113,12113,"Santa Rosa County, Florida",60607,56153,369,51047,4737,4454
0500000US12115,12115,"Sarasota County, Florida",177998,158436,709,144105,13622,19562
0500000US12117,12117,"Seminole County, Florida",161371,151719,649,142484,8586,9652
0500000US12119,12119,"Sumter County, Florida",52360,47326,714,42466,4146,5034
0500000US12121,12121,"Suwannee County, Florida",15291,12596,98,11199,1299,2695
0500000US12123,12123,"Taylor County, Florida",7406,5846,139,4727,980,1560
0500000US12125,12125,"Union County, Florida",3946,2870,108,2262,500,1076
0500000US12127,12127,"Volusia County, Florida",209885,185114,1062,157771,26281,24771
0500000US12129,12129,"Wakulla County, Florida",11075,9830,106,8270,1454,1245
0500000US12131,12131,"Walton County, Florida",25449,22162,144,19378,2640,3287
0500000US12133,12133,"Washington County, Florida",8558,6821,134,5654,1033,1737
0500000US13001,13001,"Appling County, Georgia",6702,4966,141,3245,1580,1736
0500000US13003,13003,"Atkinson County, Georgia",2835,1944,34,1409,501,891
0500000US13005,13005,"Bacon County, Georgia",3989,3208,47,2405,756,781
0500000US13007,13007,"Baker County, Georgia",1321,759,5,586,168,562
0500000US13009,13009,"Baldwin County, Georgia",16330,12780,113,10950,1717,3550
0500000US13011,13011,"Banks County, Georgia",6489,4738,95,3870,773,1751
0500000US13013,13013,"Barrow County, Georgia",24588,21670,224,19196,2250,2918
0500000US13015,13015,"Bartow County, Georgia",37120,32395,275,28856,3264,4725
0500000US13017,13017,"Ben Hill County, Georgia",6361,4500,25,3732,743,1861
0500000US13019,13019,"Berrien County, Georgia",7240,5585,47,4288,1250,1655
0500000US13021,13021,"Bibb County, Georgia",57319,46528,239,38366,7923,10791
0500000US13023,13023,"Bleckley County, Georgia",4155,3045,36,2592,417,1110
0500000US13025,13025,"Brantley County, Georgia",6658,5411,190,3940,1281,1247
0500000US13027,13027,"Brooks County, Georgia",6337,5097,76,4391,630,1240
0500000US13029,13029,"Bryan County, Georgia",12366,11286,120,10223,943,1080
0500000US13031,13031,"Bulloch County, Georgia",26632,23210,102,18153,4955,3422
0500000US13033,13033,"Burke County, Georgia",8068,6530,61,4998,1471,1538
0500000US13035,13035,"Butts County, Georgia",8053,6191,28,5173,990,1862
0500000US13037,13037,"Calhoun County, Georgia",1865,1271,5,1119,147,594
0500000US13039,13039,"Camden County, Georgia",18913,17030,109,15445,1476,1883
0500000US13043,13043,"Candler County, Georgia",4061,2858,14,2123,721,1203
0500000US13045,13045,"Carroll County, Georgia",41123,35477,256,30781,4440,5646
0500000US13047,13047,"Catoosa County, Georgia",24719,21357,243,19150,1964,3362
0500000US13049,13049,"Charlton County, Georgia",3537,2701,147,2089,465,836
0500000US13051,13051,"Chatham County, Georgia",107427,95582,335,86088,9159,11845
0500000US13053,13053,"Chattahoochee County, Georgia",2505,2135,0,1870,265,370
0500000US13055,13055,"Chattooga County, Georgia",9253,7033,35,6140,858,2220
0500000US13057,13057,"Cherokee County, Georgia",83150,78525,302,74899,3324,4625
0500000US13059,13059,"Clarke County, Georgia",46291,40610,145,35029,5436,5681
0500000US13061,13061,"Clay County, Georgia",1154,746,11,619,116,408
0500000US13063,13063,"Clayton County, Georgia",91604,82462,344,68190,13928,9142
0500000US13065,13065,"Clinch County, Georgia",2576,1648,25,1146,477,928
0500000US13067,13067,"Cobb County, Georgia",274361,259100,926,239276,18898,15261
0500000US13069,13069,"Coffee County, Georgia",14329,10605,73,8335,2197,3724
0500000US13071,13071,"Colquitt County, Georgia",15599,12436,69,10315,2052,3163
0500000US13073,13073,"Columbia County, Georgia",45823,42189,265,36556,5368,3634
0500000US13075,13075,"Cook County, Georgia",6065,4561,73,3553,935,1504
0500000US13077,13077,"Coweta County, Georgia",50531,45459,139,40843,4477,5072
0500000US13079,13079,"Crawford County, Georgia",4715,3873,47,3024,802,842
0500000US13081,13081,"Crisp County, Georgia",8312,6144,108,4563,1473,2168
0500000US13083,13083,"Dade County, Georgia",6089,5036,109,4141,786,1053
0500000US13085,13085,"Dawson County, Georgia",8557,7717,48,6860,809,840
0500000US13087,13087,"Decatur County, Georgia",10311,6557,45,5426,1086,3754
0500000US13089,13089,"DeKalb County, Georgia",273614,250635,736,220340,29559,22979
0500000US13091,13091,"Dodge County, Georgia",7858,5096,13,4151,932,2762
0500000US13093,13093,"Dooly County, Georgia",5171,3542,58,2750,734,1629
0500000US13095,13095,"Dougherty County, Georgia",34842,27821,59,23632,4130,7021
0500000US13097,13097,"Douglas County, Georgia",48426,44525,56,37364,7105,3901
0500000US13099,13099,"Early County, Georgia",4032,2475,36,2090,349,1557
0500000US13101,13101,"Echols County, Georgia",1502,992,5,717,270,510
0500000US13103,13103,"Effingham County, Georgia",19584,17668,271,15588,1809,1916
0500000US13105,13105,"Elbert County, Georgia",7730,5056,72,4022,962,2674
0500000US13107,13107,"Emanuel County, Georgia",8387,6339,18,4883,1438,2048
0500000US13109,13109,"Evans County, Georgia",4023,3117,31,2528,558,906
0500000US13111,13111,"Fannin County, Georgia",10175,8333,76,7416,841,1842
0500000US13113,13113,"Fayette County, Georgia",39604,36877,66,35034,1777,2727
0500000US13115,13115,"Floyd County, Georgia",35506,29098,174,26510,2414,6408
0500000US13117,13117,"Forsyth County, Georgia",70468,67201,139,64179,2883,3267
0500000US13119,13119,"Franklin County, Georgia",8322,6317,51,4904,1362,2005
0500000US13121,13121,"Fulton County, Georgia",391850,353704,908,314710,38086,38146
0500000US13123,13123,"Gilmer County, Georgia",11468,9310,134,8164,1012,2158
0500000US13125,13125,"Glascock County, Georgia",1083,812,24,665,123,271
0500000US13127,13127,"Glynn County, Georgia",33200,28162,68,24903,3191,5038
0500000US13129,13129,"Gordon County, Georgia",19959,15890,178,13622,2090,4069
0500000US13131,13131,"Grady County, Georgia",9092,7136,36,6121,979,1956
0500000US13133,13133,"Greene County, Georgia",6793,5347,33,4342,972,1446
0500000US13135,13135,"Gwinnett County, Georgia",283256,267904,929,242250,24725,15352
0500000US13137,13137,"Habersham County, Georgia",15106,11056,135,9288,1633,4050
0500000US13139,13139,"Hall County, Georgia",63095,54782,158,49273,5351,8313
0500000US13141,13141,"Hancock County, Georgia",2970,1892,0,1289,603,1078
0500000US13143,13143,"Haralson County, Georgia",11033,8972,79,7532,1361,2061
0500000US13145,13145,"Harris County, Georgia",12088,10537,208,9214,1115,1551
0500000US13147,13147,"Hart County, Georgia",9848,7402,85,5951,1366,2446
0500000US13149,13149,"Heard County, Georgia",4379,3329,53,2590,686,1050
0500000US13151,13151,"Henry County, Georgia",72697,68328,195,63092,5041,4369
0500000US13153,13153,"Houston County, Georgia",55200,47787,72,42059,5656,7413
0500000US13155,13155,"Irwin County, Georgia",3323,2207,11,1916,280,1116
0500000US13157,13157,"Jackson County, Georgia",21785,18373,166,16198,2009,3412
0500000US13159,13159,"Jasper County, Georgia",5100,4043,28,3144,871,1057
0500000US13161,13161,"Jeff Davis County, Georgia",5210,3928,8,2714,1206,1282
0500000US13163,13163,"Jefferson County, Georgia",5797,3972,65,2525,1382,1825
0500000US13165,13165,"Jenkins County, Georgia",3375,2312,54,1573,685,1063
0500000US13167,13167,"Johnson County, Georgia",3277,2286,88,1754,444,991
0500000US13169,13169,"Jones County, Georgia",10472,8956,62,7955,939,1516
0500000US13171,13171,"Lamar County, Georgia",6263,5148,16,4206,926,1115
0500000US13173,13173,"Lanier County, Georgia",3744,2758,5,1874,879,986
0500000US13175,13175,"Laurens County, Georgia",17437,12090,152,9405,2533,5347
0500000US13177,13177,"Lee County, Georgia",10292,9201,15,8471,715,1091
0500000US13179,13179,"Liberty County, Georgia",23108,21105,130,18428,2547,2003
0500000US13181,13181,"Lincoln County, Georgia",3438,2339,4,1845,490,1099
0500000US13183,13183,"Long County, Georgia",5399,4802,26,4109,667,597
0500000US13185,13185,"Lowndes County, Georgia",40318,34149,170,26276,7703,6169
0500000US13187,13187,"Lumpkin County, Georgia",11412,9837,85,8460,1292,1575
0500000US13189,13189,"McDuffie County, Georgia",8156,5788,38,4626,1124,2368
0500000US13191,13191,"McIntosh County, Georgia",5730,4607,99,3917,591,1123
0500000US13193,13193,"Macon County, Georgia",4618,3236,4,2591,641,1382
0500000US13195,13195,"Madison County, Georgia",10571,8124,132,6886,1106,2447
0500000US13197,13197,"Marion County, Georgia",3263,2303,8,1703,592,960
0500000US13199,13199,"Meriwether County, Georgia",8108,5580,179,4268,1133,2528
0500000US13201,13201,"Miller County, Georgia",2326,1373,41,1022,310,953
0500000US13205,13205,"Mitchell County, Georgia",7991,5808,62,4629,1117,2183
0500000US13207,13207,"Monroe County, Georgia",9590,8055,85,6708,1262,1535
0500000US13209,13209,"Montgomery County, Georgia",3077,2386,24,2080,282,691
0500000US13211,13211,"Morgan County, Georgia",6698,5790,60,4748,982,908
0500000US13213,13213,"Murray County, Georgia",14176,11772,135,10365,1272,2404
0500000US13215,13215,"Muscogee County, Georgia",73179,61563,153,52261,9149,11616
0500000US13217,13217,"Newton County, Georgia",35823,31996,108,28538,3350,3827
0500000US13219,13219,"Oconee County, Georgia",12693,11774,61,10581,1132,919
0500000US13221,13221,"Oglethorpe County, Georgia",5642,4084,40,3457,587,1558
0500000US13223,13223,"Paulding County, Georgia",51397,47307,139,42464,4704,4090
0500000US13225,13225,"Peach County, Georgia",10113,8234,33,7277,924,1879
0500000US13227,13227,"Pickens County, Georgia",11379,9725,0,9010,715,1654
0500000US13229,13229,"Pierce County, Georgia",6975,5566,27,4223,1316,1409
0500000US13231,13231,"Pike County, Georgia",5963,5123,54,4435,634,840
0500000US13233,13233,"Polk County, Georgia",14949,12470,103,10263,2104,2479
0500000US13235,13235,"Pulaski County, Georgia",3893,2849,30,2278,541,1044
0500000US13237,13237,"Putnam County, Georgia",8662,7711,8,6521,1182,951
0500000US13239,13239,"Quitman County, Georgia",978,610,15,404,191,368
0500000US13241,13241,"Rabun County, Georgia",6506,4947,38,4413,496,1559
0500000US13243,13243,"Randolph County, Georgia",2864,2012,73,1708,231,852
0500000US13245,13245,"Richmond County, Georgia",72361,59249,216,49189,9844,13112
0500000US13247,13247,"Rockdale County, Georgia",29937,27197,100,22666,4431,2740
0500000US13249,13249,"Schley County, Georgia",1925,1559,6,1330,223,366
0500000US13251,13251,"Screven County, Georgia",5268,3990,23,3419,548,1278
0500000US13253,13253,"Seminole County, Georgia",3353,2282,86,1853,343,1071
0500000US13255,13255,"Spalding County, Georgia",23475,18338,88,15248,3002,5137
0500000US13257,13257,"Stephens County, Georgia",9427,7600,109,6211,1280,1827
0500000US13259,13259,"Stewart County, Georgia",1780,1148,4,917,227,632
0500000US13261,13261,"Sumter County, Georgia",11871,9606,76,7802,1728,2265
0500000US13263,13263,"Talbot County, Georgia",2801,1903,53,1401,449,898
0500000US13265,13265,"Taliaferro County, Georgia",710,408,7,245,156,302
0500000US13267,13267,"Tattnall County, Georgia",8044,6550,50,5205,1295,1494
0500000US13269,13269,"Taylor County, Georgia",3554,2469,22,1886,561,1085
0500000US13271,13271,"Telfair County, Georgia",5167,2104,0,1270,834,3063
0500000US13273,13273,"Terrell County, Georgia",3290,2424,20,2110,294,866
0500000US13275,13275,"Thomas County, Georgia",17254,14113,73,12598,1442,3141
0500000US13277,13277,"Tift County, Georgia",14999,10891,146,9145,1600,4108
0500000US13279,13279,"Toombs County, Georgia",10521,7608,7,6440,1161,2913
0500000US13281,13281,"Towns County, Georgia",4588,3569,15,3177,377,1019
0500000US13283,13283,"Treutlen County, Georgia",2633,1804,12,1516,276,829
0500000US13285,13285,"Troup County, Georgia",24679,20083,59,16845,3179,4596
0500000US13287,13287,"Turner County, Georgia",3103,2314,0,2032,282,789
0500000US13289,13289,"Twiggs County, Georgia",2943,1805,57,1417,331,1138
0500000US13291,13291,"Union County, Georgia",8788,7369,50,6113,1206,1419
0500000US13293,13293,"Upson County, Georgia",10263,7794,80,6403,1311,2469
0500000US13295,13295,"Walker County, Georgia",25564,20641,233,17895,2513,4923
0500000US13297,13297,"Walton County, Georgia",30488,27271,163,23421,3687,3217
0500000US13299,13299,"Ware County, Georgia",13903,11251,88,8967,2196,2652
0500000US13301,13301,"Warren County, Georgia",2274,1429,13,898,518,845
0500000US13303,13303,"Washington County, Georgia",7384,5429,57,4433,939,1955
0500000US13305,13305,"Wayne County, Georgia",10362,8231,70,6502,1659,2131
0500000US13307,13307,"Webster County, Georgia",1091,736,47,528,161,355
0500000US13309,13309,"Wheeler County, Georgia",1972,653,50,483,120,1319
0500000US13311,13311,"White County, Georgia",11250,8628,46,7479,1103,2622
0500000US13313,13313,"Whitfield County, Georgia",35384,28815,431,25825,2559,6569
0500000US13315,13315,"Wilcox County, Georgia",2676,1633,15,1333,285,1043
0500000US13317,13317,"Wilkes County, Georgia",3971,2206,32,1640,534,1765
0500000US13319,13319,"Wilkinson County, Georgia",3288,2235,59,1752,424,1053
0500000US13321,13321,"Worth County, Georgia",7899,6006,56,5212,738,1893
0500000US15001,15001,"Hawaii County, Hawaii",67054,57062,704,49529,6829,9992
0500000US15003,15003,"Honolulu County, Hawaii",311451,280345,921,259408,20016,31106
0500000US15005,15005,"Kalawao County, Hawaii",53,39,0,32,7,14
0500000US15007,15007,"Kauai County, Hawaii",22563,19704,545,17511,1648,2859
0500000US15009,15009,"Maui County, Hawaii",54381,48162,262,43850,4050,6219
0500000US16001,16001,"Ada County, Idaho",164389,149963,1334,129371,19258,14426
0500000US16003,16003,"Adams County, Idaho",1736,1371,31,1128,212,365
0500000US16005,16005,"Bannock County, Idaho",30790,27990,186,24724,3080,2800
0500000US16007,16007,"Bear Lake County, Idaho",2313,1947,12,1765,170,366
0500000US16009,16009,"Benewah County, Idaho",3508,2763,55,2183,525,745
0500000US16011,16011,"Bingham County, Idaho",14903,12975,181,11625,1169,1928
0500000US16013,16013,"Blaine County, Idaho",8273,7585,11,7022,552,688
0500000US16015,16015,"Boise County, Idaho",3004,2647,47,2173,427,357
0500000US16017,16017,"Bonner County, Idaho",17563,14939,218,12573,2148,2624
0500000US16019,16019,"Bonneville County, Idaho",38400,34931,257,31466,3208,3469
0500000US16021,16021,"Boundary County, Idaho",4490,3797,144,2984,669,693
0500000US16023,16023,"Butte County, Idaho",1049,891,27,758,106,158
0500000US16025,16025,"Camas County, Idaho",370,294,0,236,58,76
0500000US16027,16027,"Canyon County, Idaho",69303,61151,762,50973,9416,8152
0500000US16029,16029,"Caribou County, Idaho",2533,2288,6,2093,189,245
0500000US16031,16031,"Cassia County, Idaho",7827,6917,25,6215,677,910
0500000US16033,16033,"Clark County, Idaho",313,228,7,162,59,85
0500000US16035,16035,"Clearwater County, Idaho",3706,2957,99,2515,343,749
0500000US16037,16037,"Custer County, Idaho",1850,1603,50,1376,177,247
0500000US16039,16039,"Elmore County, Idaho",10062,8744,68,7718,958,1318
0500000US16041,16041,"Franklin County, Idaho",4286,3783,58,3388,337,503
0500000US16043,16043,"Fremont County, Idaho",4383,3747,82,3297,368,636
0500000US16045,16045,"Gem County, Idaho",6404,5443,138,4626,679,961
0500000US16047,16047,"Gooding County, Idaho",5550,4492,33,3843,616,1058
0500000US16049,16049,"Idaho County, Idaho",6480,5070,143,4123,804,1410
0500000US16051,16051,"Jefferson County, Idaho",8470,7792,180,6663,949,678
0500000US16053,16053,"Jerome County, Idaho",7741,6360,81,5289,990,1381
0500000US16055,16055,"Kootenai County, Idaho",58873,53157,315,47325,5517,5716
0500000US16057,16057,"Latah County, Idaho",15448,14496,175,12599,1722,952
0500000US16059,16059,"Lemhi County, Idaho",3703,3066,50,2663,353,637
0500000US16061,16061,"Lewis County, Idaho",1626,1240,17,1015,208,386
0500000US16063,16063,"Lincoln County, Idaho",1609,1265,14,1032,219,344
0500000US16065,16065,"Madison County, Idaho",10633,10098,82,8057,1959,535
0500000US16067,16067,"Minidoka County, Idaho",7357,6419,83,5636,700,938
0500000US16069,16069,"Nez Perce County, Idaho",16308,14216,190,12225,1801,2092
0500000US16071,16071,"Oneida County, Idaho",1581,1392,18,1247,127,189
0500000US16073,16073,"Owyhee County, Idaho",4190,3148,79,2507,562,1042
0500000US16075,16075,"Payette County, Idaho",8571,7314,163,6053,1098,1257
0500000US16077,16077,"Power County, Idaho",2544,2254,2,2035,217,290
0500000US16079,16079,"Shoshone County, Idaho",5614,4682,46,3744,892,932
0500000US16081,16081,"Teton County, Idaho",3764,3324,0,2902,422,440
0500000US16083,16083,"Twin Falls County, Idaho",30096,26563,358,23238,2967,3533
0500000US16085,16085,"Valley County, Idaho",3532,3214,46,2563,605,318
0500000US16087,16087,"Washington County, Idaho",3979,3154,60,2575,519,825
0500000US17001,17001,"Adams County, Illinois",27461,22481,340,19816,2325,4980
0500000US17003,17003,"Alexander County, Illinois",2432,1351,14,1093,244,1081
0500000US17005,17005,"Bond County, Illinois",6132,5010,36,4532,442,1122
0500000US17007,17007,"Boone County, Illinois",18709,16598,132,15260,1206,2111
0500000US17009,17009,"Brown County, Illinois",2066,1610,18,1416,176,456
0500000US17011,17011,"Bureau County, Illinois",13816,11586,74,10254,1258,2230
0500000US17013,17013,"Calhoun County, Illinois",1881,1378,14,1182,182,503
0500000US17015,17015,"Carroll County, Illinois",6573,5434,33,4830,571,1139
0500000US17017,17017,"Cass County, Illinois",5160,4135,49,3453,633,1025
0500000US17019,17019,"Champaign County, Illinois",81418,74216,254,65546,8416,7202
0500000US17021,17021,"Christian County, Illinois",13892,11528,172,9997,1359,2364
0500000US17023,17023,"Clark County, Illinois",6809,5670,30,4627,1013,1139
0500000US17025,17025,"Clay County, Illinois",5624,4678,43,4069,566,946
0500000US17027,17027,"Clinton County, Illinois",14183,11703,104,10494,1105,2480
0500000US17029,17029,"Coles County, Illinois",21006,17941,30,15716,2195,3065
0500000US17031,17031,"Cook County, Illinois",1956561,1680475,10181,1487118,183176,276086
0500000US17033,17033,"Crawford County, Illinois",7665,6375,117,5496,762,1290
0500000US17035,17035,"Cumberland County, Illinois",4287,3432,44,2942,446,855
0500000US17037,17037,"DeKalb County, Illinois",37420,34047,135,31376,2536,3373
0500000US17039,17039,"De Witt County, Illinois",6704,5635,37,4893,705,1069
0500000US17041,17041,"Douglas County, Illinois",7580,5979,34,5345,600,1601
0500000US17043,17043,"DuPage County, Illinois",340669,313657,1527,293364,18766,27012
0500000US17045,17045,"Edgar County, Illinois",7669,6111,27,5438,646,1558
0500000US17047,17047,"Edwards County, Illinois",2810,2300,36,2009,255,510
0500000US17049,17049,"Effingham County, Illinois",13450,11306,141,10232,933,2144
0500000US17051,17051,"Fayette County, Illinois",7659,5492,34,4898,560,2167
0500000US17053,17053,"Ford County, Illinois",5684,4681,37,4224,420,1003
0500000US17055,17055,"Franklin County, Illinois",16346,12441,154,10457,1830,3905
0500000US17057,17057,"Fulton County, Illinois",14069,11358,147,9849,1362,2711
0500000US17059,17059,"Gallatin County, Illinois",2272,1703,19,1449,235,569
0500000US17061,17061,"Greene County, Illinois",5087,3902,56,3376,470,1185
0500000US17063,17063,"Grundy County, Illinois",19006,17096,166,15373,1557,1910
0500000US17065,17065,"Hamilton County, Illinois",3413,2659,53,2280,326,754
0500000US17067,17067,"Hancock County, Illinois",7523,5852,87,5051,714,1671
0500000US17069,17069,"Hardin County, Illinois",1452,1058,1,904,153,394
0500000US17071,17071,"Henderson County, Illinois",3019,2444,10,2102,332,575
0500000US17073,17073,"Henry County, Illinois",19991,16443,208,14438,1797,3548
0500000US17075,17075,"Iroquois County, Illinois",11845,9773,113,8682,978,2072
0500000US17077,17077,"Jackson County, Illinois",23942,20535,110,17232,3193,3407
0500000US17079,17079,"Jasper County, Illinois",3723,2837,27,2534,276,886
0500000US17081,17081,"Jefferson County, Illinois",15244,12577,87,11058,1432,2667
0500000US17083,17083,"Jersey County, Illinois",8831,7204,148,6184,872,1627
0500000US17085,17085,"Jo Daviess County, Illinois",9795,8402,81,7331,990,1393
0500000US17087,17087,"Johnson County, Illinois",4486,3184,65,2706,413,1302
0500000US17089,17089,"Kane County, Illinois",175930,160879,834,149250,10795,15051
0500000US17091,17091,"Kankakee County, Illinois",40239,34080,257,29677,4146,6159
0500000US17093,17093,"Kendall County, Illinois",39882,38075,74,36692,1309,1807
0500000US17095,17095,"Knox County, Illinois",20981,16592,187,14459,1946,4389
0500000US17097,17097,"Lake County, Illinois",244523,225618,909,211493,13216,18905
0500000US17099,17099,"LaSalle County, Illinois",44448,37447,326,34216,2905,7001
0500000US17101,17101,"Lawrence County, Illinois",6271,5008,47,4225,736,1263
0500000US17103,17103,"Lee County, Illinois",13416,11354,48,10204,1102,2062
0500000US17105,17105,"Livingston County, Illinois",14379,12204,148,10724,1332,2175
0500000US17107,17107,"Logan County, Illinois",11011,9265,72,8182,1011,1746
0500000US17109,17109,"McDonough County, Illinois",11481,9702,103,8320,1279,1779
0500000US17111,17111,"McHenry County, Illinois",110860,103243,574,98341,4328,7617
0500000US17113,17113,"McLean County, Illinois",66070,60448,535,52810,7103,5622
0500000US17115,17115,"Macon County, Illinois",44310,36833,265,32715,3853,7477
0500000US17117,17117,"Macoupin County, Illinois",18663,15687,197,14066,1424,2976
0500000US17119,17119,"Madison County, Illinois",107241,92238,610,84403,7225,15003
0500000US17121,17121,"Marion County, Illinois",16001,13195,142,11591,1462,2806
0500000US17123,17123,"Marshall County, Illinois",4900,3986,55,3533,398,914
0500000US17125,17125,"Mason County, Illinois",6034,4842,56,4185,601,1192
0500000US17127,17127,"Massac County, Illinois",6084,4098,85,3635,378,1986
0500000US17129,17129,"Menard County, Illinois",5230,4447,54,4028,365,783
0500000US17131,17131,"Mercer County, Illinois",6620,5589,79,4940,570,1031
0500000US17133,17133,"Monroe County, Illinois",13227,11604,92,10571,941,1623
0500000US17135,17135,"Montgomery County, Illinois",11234,9072,99,7720,1253,2162
0500000US17137,17137,"Morgan County, Illinois",13894,11658,143,10212,1303,2236
0500000US17139,17139,"Moultrie County, Illinois",5856,4631,55,4002,574,1225
0500000US17141,17141,"Ogle County, Illinois",20830,17915,165,15832,1918,2915
0500000US17143,17143,"Peoria County, Illinois",74515,62572,545,54005,8022,11943
0500000US17145,17145,"Perry County, Illinois",8223,6300,66,5561,673,1923
0500000US17147,17147,"Piatt County, Illinois",6676,5883,36,5412,435,793
0500000US17149,17149,"Pike County, Illinois",6629,5076,80,4183,813,1553
0500000US17151,17151,"Pope County, Illinois",1639,1097,27,921,149,542
0500000US17153,17153,"Pulaski County, Illinois",2246,1343,15,1162,166,903
0500000US17155,17155,"Putnam County, Illinois",2438,2059,8,1766,285,379
0500000US17157,17157,"Randolph County, Illinois",12060,9489,177,8153,1159,2571
0500000US17159,17159,"Richland County, Illinois",6460,5176,101,4527,548,1284
0500000US17161,17161,"Rock Island County, Illinois",60064,50681,435,45219,5027,9383
0500000US17163,17163,"St. Clair County, Illinois",103125,82952,783,71303,10866,20173
0500000US17165,17165,"Saline County, Illinois",9938,7748,147,6396,1205,2190
0500000US17167,17167,"Sangamon County, Illinois",83673,73380,474,65356,7550,10293
0500000US17169,17169,"Schuyler County, Illinois",2856,2349,12,2127,210,507
0500000US17171,17171,"Scott County, Illinois",2111,1730,27,1523,180,381
0500000US17173,17173,"Shelby County, Illinois",9183,7514,241,6046,1227,1669
0500000US17175,17175,"Stark County, Illinois",2330,1843,14,1628,201,487
0500000US17177,17177,"Stephenson County, Illinois",19604,16258,110,14693,1455,3346
0500000US17179,17179,"Tazewell County, Illinois",54751,47354,312,42833,4209,7397
0500000US17181,17181,"Union County, Illinois",6686,4846,109,4077,660,1840
0500000US17183,17183,"Vermilion County, Illinois",31355,23965,250,20953,2762,7390
0500000US17185,17185,"Wabash County, Illinois",4915,4075,116,3453,506,840
0500000US17187,17187,"Warren County, Illinois",6802,5629,139,4823,667,1173
0500000US17189,17189,"Washington County, Illinois",5897,4669,50,4165,454,1228
0500000US17191,17191,"Wayne County, Illinois",7117,5398,88,4573,737,1719
0500000US17193,17193,"White County, Illinois",6144,4970,93,4327,550,1174
0500000US17195,17195,"Whiteside County, Illinois",23468,19405,122,17616,1667,4063
0500000US17197,17197,"Will County, Illinois",226668,208049,1123,193217,13709,18619
0500000US17199,17199,"Williamson County, Illinois",26862,21348,279,19174,1895,5514
0500000US17201,17201,"Winnebago County, Illinois",114491,98576,811,87612,10153,15915
0500000US17203,17203,"Woodford County, Illinois",14547,12669,163,11403,1103,1878
0500000US18001,18001,"Adams County, Indiana",12453,9323,300,7875,1148,3130
0500000US18003,18003,"Allen County, Indiana",142696,125746,786,110944,14016,16950
0500000US18005,18005,"Bartholomew County, Indiana",31472,26788,212,23495,3081,4684
0500000US18007,18007,"Benton County, Indiana",3397,2923,60,2358,505,474
0500000US18009,18009,"Blackford County, Indiana",5199,4212,45,3395,772,987
0500000US18011,18011,"Boone County, Indiana",24228,22136,156,20146,1834,2092
0500000US18013,18013,"Brown County, Indiana",6011,5223,83,3928,1212,788
0500000US18015,18015,"Carroll County, Indiana",7819,6535,85,5517,933,1284
0500000US18017,18017,"Cass County, Indiana",14840,12280,105,10292,1883,2560
0500000US18019,18019,"Clark County, Indiana",43657,37337,302,31950,5085,6320
0500000US18021,18021,"Clay County, Indiana",10680,8840,210,7511,1119,1840
0500000US18023,18023,"Clinton County, Indiana",11961,10209,131,8541,1537,1752
0500000US18025,18025,"Crawford County, Indiana",4007,3022,98,2229,695,985
0500000US18027,18027,"Daviess County, Indiana",11482,8288,152,6833,1303,3194
0500000US18029,18029,"Dearborn County, Indiana",18667,16379,336,14356,1687,2288
0500000US18031,18031,"Decatur County, Indiana",10354,8511,128,6781,1602,1843
0500000US18033,18033,"DeKalb County, Indiana",16317,14098,189,12157,1752,2219
0500000US18035,18035,"Delaware County, Indiana",46304,39750,275,33923,5552,6554
0500000US18037,18037,"Dubois County, Indiana",16524,13938,191,12593,1154,2586
0500000US18039,18039,"Elkhart County, Indiana",71733,59415,960,52428,6027,12318
0500000US18041,18041,"Fayette County, Indiana",9410,7459,62,5759,1638,1951
0500000US18043,18043,"Floyd County, Indiana",29046,24678,195,21475,3008,4368
0500000US18045,18045,"Fountain County, Indiana",6987,5735,44,4924,767,1252
0500000US18047,18047,"Franklin County, Indiana",8843,7103,167,5689,1247,1740
0500000US18049,18049,"Fulton County, Indiana",7934,6406,104,5171,1131,1528
0500000US18051,18051,"Gibson County, Indiana",13336,11337,94,9925,1318,1999
0500000US18053,18053,"Grant County, Indiana",26122,21375,277,16856,4242,4747
0500000US18055,18055,"Greene County, Indiana",12653,9737,107,8340,1290,2916
0500000US18057,18057,"Hamilton County, Indiana",114282,109655,665,104662,4328,4627
0500000US18059,18059,"Hancock County, Indiana",27576,25161,124,22772,2265,2415
0500000US18061,18061,"Harrison County, Indiana",14693,12470,321,10034,2115,2223
0500000US18063,18063,"Hendricks County, Indiana",57153,53183,505,48642,4036,3970
0500000US18065,18065,"Henry County, Indiana",18096,14654,200,12114,2340,3442
0500000US18067,18067,"Howard County, Indiana",34538,29098,241,25523,3334,5440
0500000US18069,18069,"Huntington County, Indiana",14616,12481,203,10514,1764,2135
0500000US18071,18071,"Jackson County, Indiana",16549,13365,183,11785,1397,3184
0500000US18073,18073,"Jasper County, Indiana",12220,10530,138,9359,1033,1690
0500000US18075,18075,"Jay County, Indiana",8195,6282,127,4979,1176,1913
0500000US18077,18077,"Jefferson County, Indiana",12677,10572,95,9149,1328,2105
0500000US18079,18079,"Jennings County, Indiana",10753,8659,106,7169,1384,2094
0500000US18081,18081,"Johnson County, Indiana",54867,49713,408,44521,4784,5154
0500000US18083,18083,"Knox County, Indiana",14986,12979,92,11047,1840,2007
0500000US18085,18085,"Kosciusko County, Indiana",30265,25879,339,22268,3272,4386
0500000US18087,18087,"LaGrange County, Indiana",12064,7714,92,6471,1151,4350
0500000US18089,18089,"Lake County, Indiana",185524,156525,1238,137047,18240,28999
0500000US18091,18091,"LaPorte County, Indiana",42975,36851,359,31607,4885,6124
0500000US18093,18093,"Lawrence County, Indiana",18432,14950,214,12700,2036,3482
0500000US18095,18095,"Madison County, Indiana",51647,42834,276,37814,4744,8813
0500000US18097,18097,"Marion County, Indiana",367215,308439,1570,270078,36791,58776
0500000US18099,18099,"Marshall County, Indiana",17249,14039,167,11586,2286,3210
0500000US18101,18101,"Martin County, Indiana",4251,3311,58,2866,387,940
0500000US18103,18103,"Miami County, Indiana",13465,11373,110,9472,1791,2092
0500000US18105,18105,"Monroe County, Indiana",55014,50411,235,43833,6343,4603
0500000US18107,18107,"Montgomery County, Indiana",14993,12987,101,11383,1503,2006
0500000US18109,18109,"Morgan County, Indiana",25805,22661,282,19326,3053,3144
0500000US18111,18111,"Newton County, Indiana",5530,4724,64,4080,580,806
0500000US18113,18113,"Noble County, Indiana",18205,15570,264,13546,1760,2635
0500000US18115,18115,"Ohio County, Indiana",2479,1925,22,1743,160,554
0500000US18117,18117,"Orange County, Indiana",7830,5934,122,4740,1072,1896
0500000US18119,18119,"Owen County, Indiana",8551,6652,82,5377,1193,1899
0500000US18121,18121,"Parke County, Indiana",6112,4532,87,3851,594,1580
0500000US18123,18123,"Perry County, Indiana",7460,5695,93,4853,749,1765
0500000US18125,18125,"Pike County, Indiana",5096,3946,99,3218,629,1150
0500000US18127,18127,"Porter County, Indiana",63251,56915,695,51051,5169,6336
0500000US18129,18129,"Posey County, Indiana",10140,8838,97,7513,1228,1302
0500000US18131,18131,"Pulaski County, Indiana",5296,4330,99,3629,602,966
0500000US18133,18133,"Putnam County, Indiana",13162,11680,162,9914,1604,1482
0500000US18135,18135,"Randolph County, Indiana",10495,8645,146,7207,1292,1850
0500000US18137,18137,"Ripley County, Indiana",11150,9383,142,8081,1160,1767
0500000US18139,18139,"Rush County, Indiana",6672,5295,54,3876,1365,1377
0500000US18141,18141,"St. Joseph County, Indiana",100694,83961,771,73420,9770,16733
0500000US18143,18143,"Scott County, Indiana",8892,7227,103,5914,1210,1665
0500000US18145,18145,"Shelby County, Indiana",17603,14728,128,12388,2212,2875
0500000US18147,18147,"Spencer County, Indiana",8101,6341,77,5445,819,1760
0500000US18149,18149,"Starke County, Indiana",8792,7093,153,5731,1209,1699
0500000US18151,18151,"Steuben County, Indiana",13810,12084,189,10555,1340,1726
0500000US18153,18153,"Sullivan County, Indiana",7601,5766,43,4798,925,1835
0500000US18155,18155,"Switzerland County, Indiana",4259,3287,104,2657,526,972
0500000US18157,18157,"Tippecanoe County, Indiana",68771,63471,351,54683,8437,5300
0500000US18159,18159,"Tipton County, Indiana",6365,5416,67,4652,697,949
0500000US18161,18161,"Union County, Indiana",2860,2323,51,1793,479,537
0500000US18163,18163,"Vanderburgh County, Indiana",74923,63501,379,55732,7390,11422
0500000US18165,18165,"Vermillion County, Indiana",6533,5377,43,4683,651,1156
0500000US18167,18167,"Vigo County, Indiana",41164,34539,383,29581,4575,6625
0500000US18169,18169,"Wabash County, Indiana",12920,11034,191,8917,1926,1886
0500000US18171,18171,"Warren County, Indiana",3395,2886,70,2396,420,509
0500000US18173,18173,"Warrick County, Indiana",23742,21331,174,19264,1893,2411
0500000US18175,18175,"Washington County, Indiana",10570,8072,181,6600,1291,2498
0500000US18177,18177,"Wayne County, Indiana",26397,21482,241,17099,4142,4915
0500000US18179,18179,"Wells County, Indiana",10944,9362,113,8035,1214,1582
0500000US18181,18181,"White County, Indiana",9723,8265,94,7156,1015,1458
0500000US18183,18183,"Whitley County, Indiana",13469,11853,195,10012,1646,1616
0500000US19001,19001,"Adair County, Iowa",3210,2691,53,2242,396,519
0500000US19003,19003,"Adams County, Iowa",1654,1312,30,1105,177,342
0500000US19005,19005,"Allamakee County, Iowa",6037,4625,71,3995,559,1412
0500000US19007,19007,"Appanoose County, Iowa",5407,4260,71,3532,657,1147
0500000US19009,19009,"Audubon County, Iowa",2679,2164,32,1813,319,515
0500000US19011,19011,"Benton County, Iowa",10187,8693,149,7374,1170,1494
0500000US19013,19013,"Black Hawk County, Iowa",52811,45214,323,40596,4295,7597
0500000US19015,19015,"Boone County, Iowa",10998,9729,100,8271,1358,1269
0500000US19017,19017,"Bremer County, Iowa",9445,8072,88,7229,755,1373
0500000US19019,19019,"Buchanan County, Iowa",8212,6768,99,6042,627,1444
0500000US19021,19021,"Buena Vista County, Iowa",7561,6510,79,5813,618,1051
0500000US19023,19023,"Butler County, Iowa",6278,4962,111,4368,483,1316
0500000US19025,19025,"Calhoun County, Iowa",4229,3424,32,2978,414,805
0500000US19027,19027,"Carroll County, Iowa",8675,6999,70,6311,618,1676
0500000US19029,19029,"Cass County, Iowa",6053,4950,35,4185,730,1103
0500000US19031,19031,"Cedar County, Iowa",7546,6454,198,5715,541,1092
0500000US19033,19033,"Cerro Gordo County, Iowa",19201,15912,104,13928,1880,3289
0500000US19035,19035,"Cherokee County, Iowa",5227,4359,38,4055,266,868
0500000US19037,19037,"Chickasaw County, Iowa",5298,4329,108,3799,422,969
0500000US19039,19039,"Clarke County, Iowa",3870,3324,15,2862,447,546
0500000US19041,19041,"Clay County, Iowa",7264,6287,25,5481,781,977
0500000US19043,19043,"Clayton County, Iowa",7625,5900,59,5182,659,1725
0500000US19045,19045,"Clinton County, Iowa",19877,16200,188,14417,1595,3677
0500000US19047,19047,"Crawford County, Iowa",6389,5054,77,4220,757,1335
0500000US19049,19049,"Dallas County, Iowa",31363,29460,185,27243,2032,1903
0500000US19051,19051,"Davis County, Iowa",3255,2336,19,2002,315,919
0500000US19053,19053,"Decatur County, Iowa",3172,2420,22,2010,388,752
0500000US19055,19055,"Delaware County, Iowa",6926,5780,182,5011,587,1146
0500000US19057,19057,"Des Moines County, Iowa",16772,14056,122,12370,1564,2716
0500000US19059,19059,"Dickinson County, Iowa",8039,7129,51,6284,794,910
0500000US19061,19061,"Dubuque County, Iowa",38076,33312,344,29971,2997,4764
0500000US19063,19063,"Emmet County, Iowa",4133,3404,55,2926,423,729
0500000US19065,19065,"Fayette County, Iowa",8315,6770,153,5911,706,1545
0500000US19067,19067,"Floyd County, Iowa",6924,5564,57,4947,560,1360
0500000US19069,19069,"Franklin County, Iowa",4232,3249,93,2813,343,983
0500000US19071,19071,"Fremont County, Iowa",2997,2493,57,2189,247,504
0500000US19073,19073,"Greene County, Iowa",3912,3325,65,2769,491,587
0500000US19075,19075,"Grundy County, Iowa",5155,4360,67,3935,358,795
0500000US19077,19077,"Guthrie County, Iowa",4393,3653,85,3169,399,740
0500000US19079,19079,"Hamilton County, Iowa",6367,5295,52,4511,732,1072
0500000US19081,19081,"Hancock County, Iowa",4809,3947,30,3302,615,862
0500000US19083,19083,"Hardin County, Iowa",7183,5761,137,4948,676,1422
0500000US19085,19085,"Harrison County, Iowa",6068,5033,104,4222,707,1035
0500000US19087,19087,"Henry County, Iowa",7772,6507,71,5613,823,1265
0500000US19089,19089,"Howard County, Iowa",3883,3116,40,2701,375,767
0500000US19091,19091,"Humboldt County, Iowa",4221,3431,45,3064,322,790
0500000US19093,19093,"Ida County, Iowa",3043,2451,29,2203,219,592
0500000US19095,19095,"Iowa County, Iowa",6766,5768,146,4758,864,998
0500000US19097,19097,"Jackson County, Iowa",8395,6633,73,5911,649,1762
0500000US19099,19099,"Jasper County, Iowa",14533,12259,264,10482,1513,2274
0500000US19101,19101,"Jefferson County, Iowa",6872,5962,63,5420,479,910
0500000US19103,19103,"Johnson County, Iowa",57423,53792,243,49609,3940,3631
0500000US19105,19105,"Jones County, Iowa",8264,6761,95,5871,795,1503
0500000US19107,19107,"Keokuk County, Iowa",4471,3505,36,3039,430,966
0500000US19109,19109,"Kossuth County, Iowa",6674,5630,69,4893,668,1044
0500000US19111,19111,"Lee County, Iowa",14204,11566,122,9957,1487,2638
0500000US19113,19113,"Linn County, Iowa",89061,79375,724,71333,7318,9686
0500000US19115,19115,"Louisa County, Iowa",4364,3592,39,3258,295,772
0500000US19117,19117,"Lucas County, Iowa",3703,3084,23,2635,426,619
0500000US19119,19119,"Lyon County, Iowa",4489,3962,28,3554,380,527
0500000US19121,19121,"Madison County, Iowa",6357,5388,52,4757,579,969
0500000US19123,19123,"Mahaska County, Iowa",8955,7564,61,6755,748,1391
0500000US19125,19125,"Marion County, Iowa",13098,11104,151,9771,1182,1994
0500000US19127,19127,"Marshall County, Iowa",15541,12992,254,10805,1933,2549
0500000US19129,19129,"Mills County, Iowa",5601,4814,92,4303,419,787
0500000US19131,19131,"Mitchell County, Iowa",4302,3456,24,3058,374,846
0500000US19133,19133,"Monona County, Iowa",4047,3278,50,2851,377,769
0500000US19135,19135,"Monroe County, Iowa",3347,2814,38,2329,447,533
0500000US19137,19137,"Montgomery County, Iowa",4614,3846,31,3279,536,768
0500000US19139,19139,"Muscatine County, Iowa",16414,13943,130,12226,1587,2471
0500000US19141,19141,"O'Brien County, Iowa",6101,5105,85,4294,726,996
0500000US19143,19143,"Osceola County, Iowa",2617,2187,28,1993,166,430
0500000US19145,19145,"Page County, Iowa",6405,5366,71,4642,653,1039
0500000US19147,19147,"Palo Alto County, Iowa",3823,3257,13,2810,434,566
0500000US19149,19149,"Plymouth County, Iowa",10083,8639,58,7816,765,1444
0500000US19151,19151,"Pocahontas County, Iowa",3191,2653,41,2330,282,538
0500000US19153,19153,"Polk County, Iowa",181316,164856,1429,146776,16651,16460
0500000US19155,19155,"Pottawattamie County, Iowa",36926,31275,330,27349,3596,5651
0500000US19157,19157,"Poweshiek County, Iowa",7571,6445,166,5440,839,1126
0500000US19159,19159,"Ringgold County, Iowa",2063,1607,29,1376,202,456
0500000US19161,19161,"Sac County, Iowa",4372,3653,54,3153,446,719
0500000US19163,19163,"Scott County, Iowa",67100,56551,591,50796,5164,10549
0500000US19165,19165,"Shelby County, Iowa",5055,4132,50,3711,371,923
0500000US19167,19167,"Sioux County, Iowa",12113,10653,120,9908,625,1460
0500000US19169,19169,"Story County, Iowa",37106,34980,226,30098,4656,2126
0500000US19171,19171,"Tama County, Iowa",6675,5696,96,4749,851,979
0500000US19173,19173,"Taylor County, Iowa",2694,2186,26,1859,301,508
0500000US19175,19175,"Union County, Iowa",5309,4341,76,3724,541,968
0500000US19177,19177,"Van Buren County, Iowa",2877,2191,69,1735,387,686
0500000US19179,19179,"Wapello County, Iowa",14531,11946,134,10205,1607,2585
0500000US19181,19181,"Warren County, Iowa",18621,16721,168,15061,1492,1900
0500000US19183,19183,"Washington County, Iowa",8669,7323,107,6294,922,1346
0500000US19185,19185,"Wayne County, Iowa",2631,1909,17,1708,184,722
0500000US19187,19187,"Webster County, Iowa",15067,12256,102,10853,1301,2811
0500000US19189,19189,"Winnebago County, Iowa",4590,3835,66,3253,516,755
0500000US19191,19191,"Winneshiek County, Iowa",8123,6817,100,6109,608,1306
0500000US19193,19193,"Woodbury County, Iowa",38962,32736,392,27711,4633,6226
0500000US19195,19195,"Worth County, Iowa",3179,2503,18,2171,314,676
0500000US19197,19197,"Wright County, Iowa",5579,4443,116,3840,487,1136
0500000US20001,20001,"Allen County, Kansas",5325,4229,19,3670,540,1096
0500000US20003,20003,"Anderson County, Kansas",3206,2468,27,2054,387,738
0500000US20005,20005,"Atchison County, Kansas",5967,4752,90,4049,613,1215
0500000US20007,20007,"Barber County, Kansas",1967,1669,30,1356,283,298
0500000US20009,20009,"Barton County, Kansas",11288,9425,99,7916,1410,1863
0500000US20011,20011,"Bourbon County, Kansas",5622,4317,28,3559,730,1305
0500000US20013,20013,"Brown County, Kansas",3993,3263,41,2851,371,730
0500000US20015,20015,"Butler County, Kansas",24358,21237,153,19127,1957,3121
0500000US20017,20017,"Chase County, Kansas",1095,832,6,748,78,263
0500000US20019,20019,"Chautauqua County, Kansas",1432,1082,6,912,164,350
0500000US20021,20021,"Cherokee County, Kansas",7980,6428,165,5166,1097,1552
0500000US20023,20023,"Cheyenne County, Kansas",1248,1004,15,897,92,244
0500000US20025,20025,"Clark County, Kansas",912,707,8,553,146,205
0500000US20027,20027,"Clay County, Kansas",3406,2735,27,2379,329,671
0500000US20029,20029,"Cloud County, Kansas",3896,3170,33,2620,517,726
0500000US20031,20031,"Coffey County, Kansas",3592,3092,27,2718,347,500
0500000US20033,20033,"Comanche County, Kansas",726,619,2,518,99,107
0500000US20035,20035,"Cowley County, Kansas",13688,11463,135,9555,1773,2225
0500000US20037,20037,"Crawford County, Kansas",14974,12589,37,10735,1817,2385
0500000US20039,20039,"Decatur County, Kansas",1439,1175,20,1039,116,264
0500000US20041,20041,"Dickinson County, Kansas",7781,6385,66,5555,764,1396
0500000US20043,20043,"Doniphan County, Kansas",3065,2376,40,1881,455,689
0500000US20045,20045,"Douglas County, Kansas",44945,42082,128,38227,3727,2863
0500000US20047,20047,"Edwards County, Kansas",1273,1043,19,803,221,230
0500000US20049,20049,"Elk County, Kansas",1158,894,21,742,131,264
0500000US20051,20051,"Ellis County, Kansas",11647,10265,28,9259,978,1382
0500000US20053,20053,"Ellsworth County, Kansas",2500,2076,10,1819,247,424
0500000US20055,20055,"Finney County, Kansas",12648,10923,54,9607,1262,1725
0500000US20057,20057,"Ford County, Kansas",11339,9453,31,7885,1537,1886
0500000US20059,20059,"Franklin County, Kansas",9897,8276,50,6672,1554,1621
0500000US20061,20061,"Geary County, Kansas",12923,11684,85,10626,973,1239
0500000US20063,20063,"Gove County, Kansas",1193,1019,8,889,122,174
0500000US20065,20065,"Graham County, Kansas",1239,1026,18,919,89,213
0500000US20067,20067,"Grant County, Kansas",2628,2287,3,2022,262,341
0500000US20069,20069,"Gray County, Kansas",2141,1897,17,1535,345,244
0500000US20071,20071,"Greeley County, Kansas",494,413,0,376,37,81
0500000US20073,20073,"Greenwood County, Kansas",2772,2106,34,1721,351,666
0500000US20075,20075,"Hamilton County, Kansas",864,733,12,620,101,131
0500000US20077,20077,"Harper County, Kansas",2357,1937,18,1629,290,420
0500000US20079,20079,"Harvey County, Kansas",13355,11102,94,9903,1105,2253
0500000US20081,20081,"Haskell County, Kansas",1330,1129,17,969,143,201
0500000US20083,20083,"Hodgeman County, Kansas",786,674,7,568,99,112
0500000US20085,20085,"Jackson County, Kansas",5296,4345,64,3841,440,951
0500000US20087,20087,"Jefferson County, Kansas",7681,6537,96,5676,765,1144
0500000US20089,20089,"Jewell County, Kansas",1388,1054,0,907,147,334
0500000US20091,20091,"Johnson County, Kansas",224248,211909,645,201464,9800,12339
0500000US20093,20093,"Kearny County, Kansas",1242,1069,11,866,192,173
0500000US20095,20095,"Kingman County, Kansas",3148,2621,38,2176,407,527
0500000US20097,20097,"Kiowa County, Kansas",1004,813,11,653,149,191
0500000US20099,20099,"Labette County, Kansas",8098,6675,80,5667,928,1423
0500000US20101,20101,"Lane County, Kansas",828,721,8,622,91,107
0500000US20103,20103,"Leavenworth County, Kansas",27233,24594,181,21583,2830,2639
0500000US20105,20105,"Lincoln County, Kansas",1275,1037,6,880,151,238
0500000US20107,20107,"Linn County, Kansas",4433,3386,62,2405,919,1047
0500000US20109,20109,"Logan County, Kansas",1168,988,10,886,92,180
0500000US20111,20111,"Lyon County, Kansas",13552,11837,66,10441,1330,1715
0500000US20113,20113,"McPherson County, Kansas",12077,10652,49,9423,1180,1425
0500000US20115,20115,"Marion County, Kansas",4857,3920,45,3312,563,937
0500000US20117,20117,"Marshall County, Kansas",4209,3425,26,2910,489,784
0500000US20119,20119,"Meade County, Kansas",1674,1389,0,1236,153,285
0500000US20121,20121,"Miami County, Kansas",12771,11212,263,9011,1938,1559
0500000US20123,20123,"Mitchell County, Kansas",2725,2253,7,1998,248,472
0500000US20125,20125,"Montgomery County, Kansas",13619,11144,78,9327,1739,2475
0500000US20127,20127,"Morris County, Kansas",2325,1955,20,1767,168,370
0500000US20129,20129,"Morton County, Kansas",1115,893,0,771,122,222
0500000US20131,20131,"Nemaha County, Kansas",4123,3419,43,2913,463,704
0500000US20133,20133,"Neosho County, Kansas",6521,5021,56,4210,755,1500
0500000US20135,20135,"Ness County, Kansas",1327,1047,3,923,121,280
0500000US20137,20137,"Norton County, Kansas",1906,1457,28,1298,131,449
0500000US20139,20139,"Osage County, Kansas",6604,5370,110,4515,745,1234
0500000US20141,20141,"Osborne County, Kansas",1713,1415,13,1208,194,298
0500000US20143,20143,"Ottawa County, Kansas",2437,1954,48,1593,313,483
0500000US20145,20145,"Pawnee County, Kansas",2590,2092,5,1773,314,498
0500000US20147,20147,"Phillips County, Kansas",2326,1975,13,1783,179,351
0500000US20149,20149,"Pottawatomie County, Kansas",8510,7587,32,6756,799,923
0500000US20151,20151,"Pratt County, Kansas",3742,3024,18,2616,390,718
0500000US20153,20153,"Rawlins County, Kansas",1170,973,6,883,84,197
0500000US20155,20155,"Reno County, Kansas",25015,20925,175,18263,2487,4090
0500000US20157,20157,"Republic County, Kansas",2307,1738,23,1436,279,569
0500000US20159,20159,"Rice County, Kansas",3932,3223,31,2828,364,709
0500000US20161,20161,"Riley County, Kansas",26686,24964,90,22454,2420,1722
0500000US20163,20163,"Rooks County, Kansas",2144,1784,13,1556,215,360
0500000US20165,20165,"Rush County, Kansas",1432,1158,2,973,183,274
0500000US20167,20167,"Russell County, Kansas",3161,2487,15,2269,203,674
0500000US20169,20169,"Saline County, Kansas",22294,18749,97,16391,2261,3545
0500000US20171,20171,"Scott County, Kansas",2105,1911,0,1809,102,194
0500000US20173,20173,"Sedgwick County, Kansas",195072,166404,1106,147588,17710,28668
0500000US20175,20175,"Seward County, Kansas",7573,6220,64,5473,683,1353
0500000US20177,20177,"Shawnee County, Kansas",71601,60734,484,51690,8560,10867
0500000US20179,20179,"Sheridan County, Kansas",1144,976,11,861,104,168
0500000US20181,20181,"Sherman County, Kansas",2729,2351,67,2170,114,378
0500000US20183,20183,"Smith County, Kansas",1662,1322,18,1199,105,340
0500000US20185,20185,"Stafford County, Kansas",1804,1500,17,1210,273,304
0500000US20187,20187,"Stanton County, Kansas",798,664,0,506,158,134
0500000US20189,20189,"Stevens County, Kansas",1958,1762,9,1374,379,196
0500000US20191,20191,"Sumner County, Kansas",9188,7547,91,6458,998,1641
0500000US20193,20193,"Thomas County, Kansas",3259,3017,43,2712,262,242
0500000US20195,20195,"Trego County, Kansas",1389,1258,0,1155,103,131
0500000US20197,20197,"Wabaunsee County, Kansas",2732,2243,41,1979,223,489
0500000US20199,20199,"Wallace County, Kansas",594,463,0,425,38,131
0500000US20201,20201,"Washington County, Kansas",2339,1808,14,1517,277,531
0500000US20203,20203,"Wichita County, Kansas",890,761,3,623,135,129
0500000US20205,20205,"Wilson County, Kansas",3873,2910,86,2274,550,963
0500000US20207,20207,"Woodson County, Kansas",1523,1116,25,887,204,407
0500000US20209,20209,"Wyandotte County, Kansas",59355,49122,233,39619,9270,10233
0500000US21001,21001,"Adair County, Kentucky",7101,5235,97,4448,690,1866
0500000US21003,21003,"Allen County, Kentucky",7705,5910,91,4682,1137,1795
0500000US21005,21005,"Anderson County, Kentucky",8613,7345,54,6013,1278,1268
0500000US21007,21007,"Ballard County, Kentucky",3225,2541,34,2241,266,684
0500000US21009,21009,"Barren County, Kentucky",16927,13575,138,12216,1221,3352
0500000US21011,21011,"Bath County, Kentucky",4509,3435,29,2966,440,1074
0500000US21013,21013,"Bell County, Kentucky",11063,7350,20,6256,1074,3713
0500000US21015,21015,"Boone County, Kentucky",46095,42653,199,40120,2334,3442
0500000US21017,21017,"Bourbon County, Kentucky",8116,6519,63,5182,1274,1597
0500000US21019,21019,"Boyd County, Kentucky",19119,16436,160,14247,2029,2683
0500000US21021,21021,"Boyle County, Kentucky",10875,8892,49,7810,1033,1983
0500000US21023,21023,"Bracken County, Kentucky",3427,2658,74,2139,445,769
0500000US21025,21025,"Breathitt County, Kentucky",5342,3605,51,2953,601,1737
0500000US21027,21027,"Breckinridge County, Kentucky",7467,5554,52,4759,743,1913
0500000US21029,21029,"Bullitt County, Kentucky",29014,25449,246,22895,2308,3565
0500000US21031,21031,"Butler County, Kentucky",5060,3638,76,3146,416,1422
0500000US21033,21033,"Caldwell County, Kentucky",5309,4146,33,3424,689,1163
0500000US21035,21035,"Calloway County, Kentucky",14757,12698,43,10823,1832,2059
0500000US21037,21037,"Campbell County, Kentucky",35870,31469,580,27756,3133,4401
0500000US21039,21039,"Carlisle County, Kentucky",1988,1584,6,1316,262,404
0500000US21041,21041,"Carroll County, Kentucky",3962,3027,65,2201,761,935
0500000US21043,21043,"Carter County, Kentucky",10460,7850,146,6418,1286,2610
0500000US21045,21045,"Casey County, Kentucky",6398,4659,51,3960,648,1739
0500000US21047,21047,"Christian County, Kentucky",25275,20367,261,16865,3241,4908
0500000US21049,21049,"Clark County, Kentucky",14216,12021,35,10118,1868,2195
0500000US21051,21051,"Clay County, Kentucky",7719,5666,28,5085,553,2053
0500000US21053,21053,"Clinton County, Kentucky",4025,2625,140,2160,325,1400
0500000US21055,21055,"Crittenden County, Kentucky",3711,2722,74,2213,435,989
0500000US21057,21057,"Cumberland County, Kentucky",2709,1925,98,1623,204,784
0500000US21059,21059,"Daviess County, Kentucky",39531,33265,304,29435,3526,6266
0500000US21061,21061,"Edmonson County, Kentucky",4880,3841,98,3394,349,1039
0500000US21063,21063,"Elliott County, Kentucky",2635,1768,0,1535,233,867
0500000US21065,21065,"Estill County, Kentucky",5638,4081,96,3272,713,1557
0500000US21067,21067,"Fayette County, Kentucky",127336,115403,360,103453,11590,11933
0500000US21069,21069,"Fleming County, Kentucky",5849,4343,30,3910,403,1506
0500000US21071,21071,"Floyd County, Kentucky",15108,11541,82,9782,1677,3567
0500000US21073,21073,"Franklin County, Kentucky",20786,17934,11,15932,1991,2852
0500000US21075,21075,"Fulton County, Kentucky",2463,1812,0,1428,384,651
0500000US21077,21077,"Gallatin County, Kentucky",3007,2292,12,1792,488,715
0500000US21079,21079,"Garrard County, Kentucky",6925,5601,58,4847,696,1324
0500000US21081,21081,"Grant County, Kentucky",8637,6915,101,5699,1115,1722
0500000US21083,21083,"Graves County, Kentucky",14299,11040,81,9356,1603,3259
0500000US21085,21085,"Grayson County, Kentucky",9594,7672,92,5910,1670,1922
0500000US21087,21087,"Green County, Kentucky",4467,3224,36,2729,459,1243
0500000US21089,21089,"Greenup County, Kentucky",14089,11924,163,10319,1442,2165
0500000US21091,21091,"Hancock County, Kentucky",3375,2730,36,2466,228,645
0500000US21093,21093,"Hardin County, Kentucky",41051,36140,301,31503,4336,4911
0500000US21095,21095,"Harlan County, Kentucky",11249,7740,45,6392,1303,3509
0500000US21097,21097,"Harrison County, Kentucky",7107,5206,90,4179,937,1901
0500000US21099,21099,"Hart County, Kentucky",7346,5318,109,4644,565,2028
0500000US21101,21101,"Henderson County, Kentucky",18719,15322,119,13246,1957,3397
0500000US21103,21103,"Henry County, Kentucky",6104,4889,15,3921,953,1215
0500000US21105,21105,"Hickman County, Kentucky",1877,1276,31,1012,233,601
0500000US21107,21107,"Hopkins County, Kentucky",18546,14298,208,12444,1646,4248
0500000US21109,21109,"Jackson County, Kentucky",5435,3941,58,3093,790,1494
0500000US21111,21111,"Jefferson County, Kentucky",309888,265130,857,238129,26144,44758
0500000US21113,21113,"Jessamine County, Kentucky",18537,16477,95,14700,1682,2060
0500000US21115,21115,"Johnson County, Kentucky",8771,6796,37,6064,695,1975
0500000US21117,21117,"Kenton County, Kentucky",62929,55697,301,50417,4979,7232
0500000US21119,21119,"Knott County, Kentucky",6158,4529,97,3714,718,1629
0500000US21121,21121,"Knox County, Kentucky",12264,7500,87,5789,1624,4764
0500000US21123,21123,"Larue County, Kentucky",5470,4655,74,3950,631,815
0500000US21125,21125,"Laurel County, Kentucky",22976,17996,317,15802,1877,4980
0500000US21127,21127,"Lawrence County, Kentucky",6254,4661,47,4009,605,1593
0500000US21129,21129,"Lee County, Kentucky",2843,1803,26,1403,374,1040
0500000US21131,21131,"Leslie County, Kentucky",4292,2935,21,2485,429,1357
0500000US21133,21133,"Letcher County, Kentucky",10065,7656,103,6373,1180,2409
0500000US21135,21135,"Lewis County, Kentucky",5496,3875,124,3249,502,1621
0500000US21137,21137,"Lincoln County, Kentucky",9786,7183,32,5964,1187,2603
0500000US21139,21139,"Livingston County, Kentucky",4016,3005,75,2423,507,1011
0500000US21141,21141,"Logan County, Kentucky",10780,7557,42,6312,1203,3223
0500000US21143,21143,"Lyon County, Kentucky",3376,2583,20,2179,384,793
0500000US21145,21145,"McCracken County, Kentucky",27557,22122,80,19607,2435,5435
0500000US21147,21147,"McCreary County, Kentucky",6332,3701,113,2750,838,2631
0500000US21149,21149,"McLean County, Kentucky",3826,3095,36,2541,518,731
0500000US21151,21151,"Madison County, Kentucky",33036,28957,180,24725,4052,4079
0500000US21153,21153,"Magoffin County, Kentucky",5057,3588,13,3202,373,1469
0500000US21155,21155,"Marion County, Kentucky",7365,5441,69,4401,971,1924
0500000US21157,21157,"Marshall County, Kentucky",13117,11172,76,9994,1102,1945
0500000US21159,21159,"Martin County, Kentucky",4316,3086,20,2715,351,1230
0500000US21161,21161,"Mason County, Kentucky",6737,5109,51,4411,647,1628
0500000US21163,21163,"Meade County, Kentucky",10785,9327,113,8581,633,1458
0500000US21165,21165,"Menifee County, Kentucky",2537,1828,34,1586,208,709
0500000US21167,21167,"Mercer County, Kentucky",8645,6773,68,5971,734,1872
0500000US21169,21169,"Metcalfe County, Kentucky",3940,3077,6,2690,381,863
0500000US21171,21171,"Monroe County, Kentucky",4376,3127,124,2608,395,1249
0500000US21173,21173,"Montgomery County, Kentucky",10404,8506,63,6912,1531,1898
0500000US21175,21175,"Morgan County, Kentucky",4937,3547,11,3259,277,1390
0500000US21177,21177,"Muhlenberg County, Kentucky",11416,8497,144,7204,1149,2919
0500000US21179,21179,"Nelson County, Kentucky",17324,14629,139,12836,1654,2695
0500000US21181,21181,"Nicholas County, Kentucky",2760,1970,47,1606,317,790
0500000US21183,21183,"Ohio County, Kentucky",9055,6934,80,5852,1002,2121
0500000US21185,21185,"Oldham County, Kentucky",20465,19311,85,18086,1140,1154
0500000US21187,21187,"Owen County, Kentucky",3944,2875,0,2168,707,1069
0500000US21189,21189,"Owsley County, Kentucky",1696,1175,0,999,176,521
0500000US21191,21191,"Pendleton County, Kentucky",5236,4140,93,3330,717,1096
0500000US21193,21193,"Perry County, Kentucky",11037,8378,31,7529,818,2659
0500000US21195,21195,"Pike County, Kentucky",25853,20231,99,17271,2861,5622
0500000US21197,21197,"Powell County, Kentucky",4878,3450,35,2683,732,1428
0500000US21199,21199,"Pulaski County, Kentucky",25810,19652,222,16494,2936,6158
0500000US21201,21201,"Robertson County, Kentucky",938,598,18,382,198,340
0500000US21203,21203,"Rockcastle County, Kentucky",6552,4911,65,4118,728,1641
0500000US21205,21205,"Rowan County, Kentucky",8774,7386,37,6642,707,1388
0500000US21207,21207,"Russell County, Kentucky",7204,5079,141,4284,654,2125
0500000US21209,21209,"Scott County, Kentucky",19706,17816,92,15878,1846,1890
0500000US21211,21211,"Shelby County, Kentucky",16369,14112,74,12356,1682,2257
0500000US21213,21213,"Simpson County, Kentucky",6895,5119,39,4422,658,1776
0500000US21215,21215,"Spencer County, Kentucky",6678,5963,8,5529,426,715
0500000US21217,21217,"Taylor County, Kentucky",9669,7457,71,6738,648,2212
0500000US21219,21219,"Todd County, Kentucky",4610,3151,55,2434,662,1459
0500000US21221,21221,"Trigg County, Kentucky",5982,4598,62,3990,546,1384
0500000US21223,21223,"Trimble County, Kentucky",3603,3084,0,2338,746,519
0500000US21225,21225,"Union County, Kentucky",5527,4388,14,3758,616,1139
0500000US21227,21227,"Warren County, Kentucky",46443,40619,188,36333,4098,5824
0500000US21229,21229,"Washington County, Kentucky",4507,3472,70,2836,566,1035
0500000US21231,21231,"Wayne County, Kentucky",8011,5158,4,4560,594,2853
0500000US21233,21233,"Webster County, Kentucky",5095,3881,100,3006,775,1214
0500000US21235,21235,"Whitley County, Kentucky",12583,8861,35,7366,1460,3722
0500000US21237,21237,"Wolfe County, Kentucky",2853,1825,22,1546,257,1028
0500000US21239,21239,"Woodford County, Kentucky",10063,9011,82,8059,870,1052
0500000US22001,22001,"Acadia Parish, Louisiana",22675,17414,133,14785,2496,5261
0500000US22003,22003,"Allen Parish, Louisiana",7834,6118,30,5053,1035,1716
0500000US22005,22005,"Ascension Parish, Louisiana",41884,37642,131,34237,3274,4242
0500000US22007,22007,"Assumption Parish, Louisiana",8710,6647,66,5614,967,2063
0500000US22009,22009,"Avoyelles Parish, Louisiana",14961,11033,196,8975,1862,3928
0500000US22011,22011,"Beauregard Parish, Louisiana",13327,11062,126,9139,1797,2265
0500000US22013,22013,"Bienville Parish, Louisiana",5840,4101,86,3398,617,1739
0500000US22015,22015,"Bossier Parish, Louisiana",48142,40846,324,32332,8190,7296
0500000US22017,22017,"Caddo Parish, Louisiana",97283,77970,554,65279,12137,19313
0500000US22019,22019,"Calcasieu Parish, Louisiana",77130,65002,250,54005,10747,12128
0500000US22021,22021,"Caldwell Parish, Louisiana",3680,2418,28,2122,268,1262
0500000US22023,22023,"Cameron Parish, Louisiana",2686,2201,9,1757,435,485
0500000US22025,22025,"Catahoula Parish, Louisiana",3747,2477,11,1985,481,1270
0500000US22027,22027,"Claiborne Parish, Louisiana",5980,3967,44,2610,1313,2013
0500000US22029,22029,"Concordia Parish, Louisiana",7440,4821,23,4107,691,2619
0500000US22031,22031,"De Soto Parish, Louisiana",10331,7977,103,6590,1284,2354
0500000US22033,22033,"East Baton Rouge Parish, Louisiana",167188,144310,513,128054,15743,22878
0500000US22035,22035,"East Carroll Parish, Louisiana",2417,1018,9,794,215,1399
0500000US22037,22037,"East Feliciana Parish, Louisiana",6817,5209,89,3788,1332,1608
0500000US22039,22039,"Evangeline Parish, Louisiana",11928,8331,8,6877,1446,3597
0500000US22041,22041,"Franklin Parish, Louisiana",7622,4957,78,3320,1559,2665
0500000US22043,22043,"Grant Parish, Louisiana",7271,5350,28,4165,1157,1921
0500000US22045,22045,"Iberia Parish, Louisiana",26420,20995,62,17890,3043,5425
0500000US22047,22047,"Iberville Parish, Louisiana",11142,8712,5,7232,1475,2430
0500000US22049,22049,"Jackson Parish, Louisiana",6032,4520,7,4011,502,1512
0500000US22051,22051,"Jefferson Parish, Louisiana",168786,141096,704,121918,18474,27690
0500000US22053,22053,"Jefferson Davis Parish, Louisiana",11435,8742,49,7222,1471,2693
0500000US22055,22055,"Lafayette Parish, Louisiana",89677,78726,165,71830,6731,10951
0500000US22057,22057,"Lafourche Parish, Louisiana",36153,29931,70,26005,3856,6222
0500000US22059,22059,"LaSalle Parish, Louisiana",5044,3718,8,3237,473,1326
0500000US22061,22061,"Lincoln Parish, Louisiana",17370,14707,153,13144,1410,2663
0500000US22063,22063,"Livingston Parish, Louisiana",48675,42807,204,36486,6117,5868
0500000US22065,22065,"Madison Parish, Louisiana",4073,2400,107,1702,591,1673
0500000US22067,22067,"Morehouse Parish, Louisiana",10077,6265,137,4973,1155,3812
0500000US22069,22069,"Natchitoches Parish, Louisiana",14549,9728,155,7692,1881,4821
0500000US22071,22071,"Orleans Parish, Louisiana",154895,122539,474,101237,20828,32356
0500000US22073,22073,"Ouachita Parish, Louisiana",56799,44068,753,38206,5109,12731
0500000US22075,22075,"Plaquemines Parish, Louisiana",8759,7148,41,6372,735,1611
0500000US22077,22077,"Pointe Coupee Parish, Louisiana",8815,6717,55,5494,1168,2098
0500000US22079,22079,"Rapides Parish, Louisiana",48032,39210,185,34520,4505,8822
0500000US22081,22081,"Red River Parish, Louisiana",3374,2522,84,2016,422,852
0500000US22083,22083,"Richland Parish, Louisiana",7500,4628,106,3512,1010,2872
0500000US22085,22085,"Sabine Parish, Louisiana",9174,6428,243,4932,1253,2746
0500000US22087,22087,"St. Bernard Parish, Louisiana",14791,11937,69,10043,1825,2854
0500000US22089,22089,"St. Charles Parish, Louisiana",18925,16594,50,14564,1980,2331
0500000US22091,22091,"St. Helena Parish, Louisiana",3990,2822,18,1930,874,1168
0500000US22093,22093,"St. James Parish, Louisiana",7887,6175,51,5248,876,1712
0500000US22095,22095,"St. John the Baptist Parish, Louisiana",15421,13016,47,10710,2259,2405
0500000US22097,22097,"St. Landry Parish, Louisiana",30467,22283,493,18371,3419,8184
0500000US22099,22099,"St. Martin Parish, Louisiana",19435,15870,154,13144,2572,3565
0500000US22101,22101,"St. Mary Parish, Louisiana",20032,15599,103,13047,2449,4433
0500000US22103,22103,"St. Tammany Parish, Louisiana",91353,82685,306,76007,6372,8668
0500000US22105,22105,"Tangipahoa Parish, Louisiana",47598,40097,289,34264,5544,7501
0500000US22107,22107,"Tensas Parish, Louisiana",1930,965,40,799,126,965
0500000US22109,22109,"Terrebonne Parish, Louisiana",40177,34139,176,27710,6253,6038
0500000US22111,22111,"Union Parish, Louisiana",7971,5393,357,3764,1272,2578
0500000US22113,22113,"Vermilion Parish, Louisiana",21721,17343,67,14879,2397,4378
0500000US22115,22115,"Vernon Parish, Louisiana",17930,15168,134,12566,2468,2762
0500000US22117,22117,"Washington Parish, Louisiana",17542,12685,223,9237,3225,4857
0500000US22119,22119,"Webster Parish, Louisiana",15854,10449,151,7661,2637,5405
0500000US22121,22121,"West Baton Rouge Parish, Louisiana",9436,8013,18,6720,1275,1423
0500000US22123,22123,"West Carroll Parish, Louisiana",4182,2432,73,1827,532,1750
0500000US22125,22125,"West Feliciana Parish, Louisiana",3947,3255,5,2601,649,692
0500000US22127,22127,"Winn Parish, Louisiana",5382,3798,32,3427,339,1584
0500000US23001,23001,"Androscoggin County, Maine",45263,39196,391,34634,4171,6067
0500000US23003,23003,"Aroostook County, Maine",29844,23813,281,20143,3389,6031
0500000US23005,23005,"Cumberland County, Maine",118807,107939,814,99245,7880,10868
0500000US23007,23007,"Franklin County, Maine",11577,10005,128,8679,1198,1572
0500000US23009,23009,"Hancock County, Maine",23674,20493,345,17776,2372,3181
0500000US23011,23011,"Kennebec County, Maine",51055,43796,433,39052,4311,7259
0500000US23013,23013,"Knox County, Maine",17022,15022,238,13036,1748,2000
0500000US23015,23015,"Lincoln County, Maine",15241,13562,250,11437,1875,1679
0500000US23017,23017,"Oxford County, Maine",20756,17194,258,14629,2307,3562
0500000US23019,23019,"Penobscot County, Maine",61848,53292,773,46737,5782,8556
0500000US23021,23021,"Piscataquis County, Maine",7477,6065,187,4761,1117,1412
0500000US23023,23023,"Sagadahoc County, Maine",15810,13981,74,12434,1473,1829
0500000US23025,23025,"Somerset County, Maine",21392,17364,299,14839,2226,4028
0500000US23027,23027,"Waldo County, Maine",16954,14661,238,12804,1619,2293
0500000US23029,23029,"Washington County, Maine",14017,11290,257,9529,1504,2727
0500000US23031,23031,"York County, Maine",83324,74178,687,67554,5937,9146
0500000US24001,24001,"Allegany County, Maryland",27759,21771,181,19391,2199,5988
0500000US24003,24003,"Anne Arundel County, Maryland",205395,190561,683,179371,10507,14834
0500000US24005,24005,"Baltimore County, Maryland",312859,279708,1564,257781,20363,33151
0500000US24009,24009,"Calvert County, Maryland",31462,29220,204,27428,1588,2242
0500000US24011,24011,"Caroline County, Maryland",11996,9890,95,8688,1107,2106
0500000US24013,24013,"Carroll County, Maryland",60432,54475,577,50119,3779,5957
0500000US24015,24015,"Cecil County, Maryland",37076,32175,203,28797,3175,4901
0500000US24017,24017,"Charles County, Maryland",54988,49503,293,46276,2934,5485
0500000US24019,24019,"Dorchester County, Maryland",12940,10608,186,9038,1384,2332
0500000US24021,24021,"Frederick County, Maryland",90022,81971,613,76329,5029,8051
0500000US24023,24023,"Garrett County, Maryland",11865,9546,160,8082,1304,2319
0500000US24025,24025,"Harford County, Maryland",92895,84543,522,78554,5467,8352
0500000US24027,24027,"Howard County, Maryland",111337,107090,205,102965,3920,4247
0500000US24029,24029,"Kent County, Maryland",7605,6216,32,5475,709,1389
0500000US24031,24031,"Montgomery County, Maryland",369242,351054,1202,329592,20260,18188
0500000US24033,24033,"Prince George's County, Maryland",306694,282628,1350,253477,27801,24066
0500000US24035,24035,"Queen Anne's County, Maryland",17995,16296,116,15175,1005,1699
0500000US24037,24037,"St. Mary's County, Maryland",39276,34349,377,30678,3294,4927
0500000US24039,24039,"Somerset County, Maryland",8362,6747,84,5291,1372,1615
0500000US24041,24041,"Talbot County, Maryland",16498,14454,126,12986,1342,2044
0500000US24043,24043,"Washington County, Maryland",55999,46459,582,40175,5702,9540
0500000US24045,24045,"Wicomico County, Maryland",37415,32969,267,27890,4812,4446
0500000US24047,24047,"Worcester County, Maryland",21190,18170,208,16160,1802,3020
0500000US24510,24510,"Baltimore city, Maryland",239791,196249,1317,164747,30185,43542
0500000US25001,25001,"Barnstable County, Massachusetts",95011,86009,726,78907,6376,9002
0500000US25003,25003,"Berkshire County, Massachusetts",55063,47376,586,42748,4042,7687
0500000US25005,25005,"Bristol County, Massachusetts",215903,182928,886,166643,15399,32975
0500000US25007,25007,"Dukes County, Massachusetts",6139,5563,43,4730,790,576
0500000US25009,25009,"Essex County, Massachusetts",291659,258123,1159,239058,17906,33536
0500000US25011,25011,"Franklin County, Massachusetts",30512,26421,371,23506,2544,4091
0500000US25013,25013,"Hampden County, Massachusetts",178931,149381,952,133715,14714,29550
0500000US25015,25015,"Hampshire County, Massachusetts",58782,53206,398,49943,2865,5576
0500000US25017,25017,"Middlesex County, Massachusetts",593784,541184,1906,511791,27487,52600
0500000US25019,25019,"Nantucket County, Massachusetts",3761,3591,10,3398,183,170
0500000US25021,25021,"Norfolk County, Massachusetts",262324,240459,833,227686,11940,21865
0500000US25023,25023,"Plymouth County, Massachusetts",184195,167473,706,156700,10067,16722
0500000US25025,25025,"Suffolk County, Massachusetts",303676,266252,951,242660,22641,37424
0500000US25027,25027,"Worcester County, Massachusetts",305975,271313,1544,249431,20338,34662
0500000US26001,26001,"Alcona County, Michigan",4979,3883,88,3212,583,1096
0500000US26003,26003,"Alger County, Michigan",3244,2504,39,2188,277,740
0500000US26005,26005,"Allegan County, Michigan",42556,34727,443,30510,3774,7829
0500000US26007,26007,"Alpena County, Michigan",12789,10481,122,8912,1447,2308
0500000US26009,26009,"Antrim County, Michigan",9732,8439,109,7014,1316,1293
0500000US26011,26011,"Arenac County, Michigan",6663,5088,100,4064,924,1575
0500000US26013,26013,"Baraga County, Michigan",3009,2362,49,2066,247,647
0500000US26015,26015,"Barry County, Michigan",23539,20359,318,17830,2211,3180
0500000US26017,26017,"Bay County, Michigan",44070,36492,339,32727,3426,7578
0500000US26019,26019,"Benzie County, Michigan",6911,5992,81,5270,641,919
0500000US26021,26021,"Berrien County, Michigan",63035,53100,611,45222,7267,9935
0500000US26023,26023,"Branch County, Michigan",16415,13606,176,11826,1604,2809
0500000US26025,26025,"Calhoun County, Michigan",53528,44510,473,38157,5880,9018
0500000US26027,26027,"Cass County, Michigan",20686,17659,223,14832,2604,3027
0500000US26029,26029,"Charlevoix County, Michigan",11234,9884,148,8434,1302,1350
0500000US26031,26031,"Cheboygan County, Michigan",11348,9207,151,7656,1400,2141
0500000US26033,26033,"Chippewa County, Michigan",14004,11444,223,9841,1380,2560
0500000US26035,26035,"Clare County, Michigan",12726,9965,147,7926,1892,2761
0500000US26037,26037,"Clinton County, Michigan",29163,26149,355,23847,1947,3014
0500000US26039,26039,"Crawford County, Michigan",6025,5046,56,4342,648,979
0500000US26041,26041,"Delta County, Michigan",15920,13009,146,11356,1507,2911
0500000US26043,26043,"Dickinson County, Michigan",11269,9198,120,8116,962,2071
0500000US26045,26045,"Eaton County, Michigan",44323,39447,334,34659,4454,4876
0500000US26047,26047,"Emmet County, Michigan",14496,12514,164,10980,1370,1982
0500000US26049,26049,"Genesee County, Michigan",166838,138476,925,119043,18508,28362
0500000US26051,26051,"Gladwin County, Michigan",10990,8141,154,6430,1557,2849
0500000US26053,26053,"Gogebic County, Michigan",6660,5056,52,3917,1087,1604
0500000US26055,26055,"Grand Traverse County, Michigan",36519,32957,203,29762,2992,3562
0500000US26057,26057,"Gratiot County, Michigan",14736,12275,146,9763,2366,2461
0500000US26059,26059,"Hillsdale County, Michigan",17896,14090,234,11824,2032,3806
0500000US26061,26061,"Houghton County, Michigan",13157,10905,55,9514,1336,2252
0500000US26063,26063,"Huron County, Michigan",13880,11077,125,9203,1749,2803
0500000US26065,26065,"Ingham County, Michigan",111894,100488,653,87648,12187,11406
0500000US26067,26067,"Ionia County, Michigan",22625,19652,243,16647,2762,2973
0500000US26069,26069,"Iosco County, Michigan",11457,9209,154,8115,940,2248
0500000US26071,26071,"Iron County, Michigan",5315,4022,87,3043,892,1293
0500000US26073,26073,"Isabella County, Michigan",24898,22268,251,17420,4597,2630
0500000US26075,26075,"Jackson County, Michigan",61418,52904,457,45584,6863,8514
0500000US26077,26077,"Kalamazoo County, Michigan",102362,92204,479,83661,8064,10158
0500000US26079,26079,"Kalkaska County, Michigan",7019,5770,157,4548,1065,1249
0500000US26081,26081,"Kent County, Michigan",236929,211878,1292,192307,18279,25051
0500000US26083,26083,"Keweenaw County, Michigan",1013,783,15,623,145,230
0500000US26085,26085,"Lake County, Michigan",4555,3265,59,2545,661,1290
0500000US26087,26087,"Lapeer County, Michigan",33152,29095,469,25094,3532,4057
0500000US26089,26089,"Leelanau County, Michigan",9022,8069,91,7321,657,953
0500000US26091,26091,"Lenawee County, Michigan",38115,33161,376,29148,3637,4954
0500000US26093,26093,"Livingston County, Michigan",70831,65447,417,59251,5779,5384
0500000US26095,26095,"Luce County, Michigan",2253,1661,56,1372,233,592
0500000US26097,26097,"Mackinac County, Michigan",5132,4148,84,3349,715,984
0500000US26099,26099,"Macomb County, Michigan",341532,298796,1280,274421,23095,42736
0500000US26101,26101,"Manistee County, Michigan",9810,8005,111,6986,908,1805
0500000US26103,26103,"Marquette County, Michigan",26199,22590,155,19561,2874,3609
0500000US26105,26105,"Mason County, Michigan",12186,10304,154,8598,1552,1882
0500000US26107,26107,"Mecosta County, Michigan",15641,13253,297,10835,2121,2388
0500000US26109,26109,"Menominee County, Michigan",10593,8400,120,7136,1144,2193
0500000US26111,26111,"Midland County, Michigan",33986,29425,419,26023,2983,4561
0500000US26113,26113,"Missaukee County, Michigan",5941,4915,90,4016,809,1026
0500000US26115,26115,"Monroe County, Michigan",58652,50966,612,45028,5326,7686
0500000US26117,26117,"Montcalm County, Michigan",23556,19154,269,15550,3335,4402
0500000US26119,26119,"Montmorency County, Michigan",4074,3233,81,2670,482,841
0500000US26121,26121,"Muskegon County, Michigan",65216,55012,572,47550,6890,10204
0500000US26123,26123,"Newaygo County, Michigan",18772,15250,388,11958,2904,3522
0500000US26125,26125,"Oakland County, Michigan",499617,459369,2094,424827,32448,40248
0500000US26127,26127,"Oceana County, Michigan",10176,8363,169,6590,1604,1813
0500000US26129,26129,"Ogemaw County, Michigan",9325,7437,148,6050,1239,1888
0500000US26131,26131,"Ontonagon County, Michigan",2945,2189,49,1681,459,756
0500000US26133,26133,"Osceola County, Michigan",9010,6988,135,5230,1623,2022
0500000US26135,26135,"Oscoda County, Michigan",3728,2658,114,2146,398,1070
0500000US26137,26137,"Otsego County, Michigan",9880,8544,126,7318,1100,1336
0500000US26139,26139,"Ottawa County, Michigan",99721,90488,586,82443,7459,9233
0500000US26141,26141,"Presque Isle County, Michigan",5929,4609,150,3696,763,1320
0500000US26143,26143,"Roscommon County, Michigan",11131,9060,91,7874,1095,2071
0500000US26145,26145,"Saginaw County, Michigan",78482,63607,525,56146,6936,14875
0500000US26147,26147,"St. Clair County, Michigan",64387,55698,725,49627,5346,8689
0500000US26149,26149,"St. Joseph County, Michigan",23831,19749,243,16730,2776,4082
0500000US26151,26151,"Sanilac County, Michigan",17121,13794,267,11272,2255,3327
0500000US26153,26153,"Schoolcraft County, Michigan",3282,2453,94,2020,339,829
0500000US26155,26155,"Shiawassee County, Michigan",27623,23490,266,20482,2742,4133
0500000US26157,26157,"Tuscola County, Michigan",21624,18011,312,14899,2800,3613
0500000US26159,26159,"Van Buren County, Michigan",29151,24219,346,20242,3631,4932
0500000US26161,26161,"Washtenaw County, Michigan",138947,129378,671,118012,10695,9569
0500000US26163,26163,"Wayne County, Michigan",673143,562509,3213,458073,101223,110634
0500000US26165,26165,"Wexford County, Michigan",13105,10730,168,8702,1860,2375
0500000US27001,27001,"Aitkin County, Minnesota",7709,6272,108,5095,1069,1437
0500000US27003,27003,"Anoka County, Minnesota",126072,115653,1181,107498,6974,10419
0500000US27005,27005,"Becker County, Minnesota",13489,11226,182,9759,1285,2263
0500000US27007,27007,"Beltrami County, Minnesota",17076,14627,82,12941,1604,2449
0500000US27009,27009,"Benton County, Minnesota",16005,14111,104,12410,1597,1894
0500000US27011,27011,"Big Stone County, Minnesota",2264,1738,14,1572,152,526
0500000US27013,27013,"Blue Earth County, Minnesota",25558,23103,132,21007,1964,2455
0500000US27015,27015,"Brown County, Minnesota",10668,9006,106,8012,888,1662
0500000US27017,27017,"Carlton County, Minnesota",13413,11123,190,9230,1703,2290
0500000US27019,27019,"Carver County, Minnesota",35342,32984,244,30723,2017,2358
0500000US27021,27021,"Cass County, Minnesota",12965,10810,159,9317,1334,2155
0500000US27023,27023,"Chippewa County, Minnesota",5019,4199,172,3594,433,820
0500000US27025,27025,"Chisago County, Minnesota",19871,17863,208,16302,1353,2008
0500000US27027,27027,"Clay County, Minnesota",23453,20117,117,17474,2526,3336
0500000US27029,27029,"Clearwater County, Minnesota",3428,2704,33,2343,328,724
0500000US27031,27031,"Cook County, Minnesota",2700,2328,99,1873,356,372
0500000US27033,27033,"Cottonwood County, Minnesota",4837,3970,42,3462,466,867
0500000US27035,27035,"Crow Wing County, Minnesota",26314,22914,272,20722,1920,3400
0500000US27037,27037,"Dakota County, Minnesota",158777,148178,762,137091,10325,10599
0500000US27039,27039,"Dodge County, Minnesota",7690,6875,60,6358,457,815
0500000US27041,27041,"Douglas County, Minnesota",16175,13920,318,12014,1588,2255
0500000US27043,27043,"Faribault County, Minnesota",6245,5051,72,4354,625,1194
0500000US27045,27045,"Fillmore County, Minnesota",8614,7057,141,6107,809,1557
0500000US27047,27047,"Freeborn County, Minnesota",12958,10821,127,9384,1310,2137
0500000US27049,27049,"Goodhue County, Minnesota",19345,16979,265,15154,1560,2366
0500000US27051,27051,"Grant County, Minnesota",2536,2133,70,1754,309,403
0500000US27053,27053,"Hennepin County, Minnesota",499104,456887,3041,414406,39440,42217
0500000US27055,27055,"Houston County, Minnesota",8114,6922,107,6279,536,1192
0500000US27057,27057,"Hubbard County, Minnesota",8758,7591,178,6492,921,1167
0500000US27059,27059,"Isanti County, Minnesota",14571,12691,242,11125,1324,1880
0500000US27061,27061,"Itasca County, Minnesota",19356,16206,116,14384,1706,3150
0500000US27063,27063,"Jackson County, Minnesota",4350,3613,48,3197,368,737
0500000US27065,27065,"Kanabec County, Minnesota",6353,5241,93,4232,916,1112
0500000US27067,27067,"Kandiyohi County, Minnesota",16765,14467,159,12762,1546,2298
0500000US27069,27069,"Kittson County, Minnesota",1891,1489,34,1043,412,402
0500000US27071,27071,"Koochiching County, Minnesota",5629,4487,51,3884,552,1142
0500000US27073,27073,"Lac qui Parle County, Minnesota",3171,2557,20,2252,285,614
0500000US27075,27075,"Lake County, Minnesota",5082,4347,104,3784,459,735
0500000US27077,27077,"Lake of the Woods County, Minnesota",1533,1225,15,643,567,308
0500000US27079,27079,"Le Sueur County, Minnesota",10844,9504,143,8304,1057,1340
0500000US27081,27081,"Lincoln County, Minnesota",2484,1917,26,1688,203,567
0500000US27083,27083,"Lyon County, Minnesota",10060,8893,97,8004,792,1167
0500000US27085,27085,"McLeod County, Minnesota",14760,12780,154,11529,1097,1980
0500000US27087,27087,"Mahnomen County, Minnesota",1947,1427,21,1160,246,520
0500000US27089,27089,"Marshall County, Minnesota",3953,3221,104,2691,426,732
0500000US27091,27091,"Martin County, Minnesota",8685,7091,123,6380,588,1594
0500000US27093,27093,"Meeker County, Minnesota",9164,7676,103,6553,1020,1488
0500000US27095,27095,"Mille Lacs County, Minnesota",10116,8358,107,7178,1073,1758
0500000US27097,27097,"Morrison County, Minnesota",13327,10744,164,9365,1215,2583
0500000US27099,27099,"Mower County, Minnesota",15524,13100,143,11625,1332,2424
0500000US27101,27101,"Murray County, Minnesota",3713,3067,44,2697,326,646
0500000US27103,27103,"Nicollet County, Minnesota",12662,11158,116,10236,806,1504
0500000US27105,27105,"Nobles County, Minnesota",7917,6652,88,5737,827,1265
0500000US27107,27107,"Norman County, Minnesota",2733,2048,34,1613,401,685
0500000US27109,27109,"Olmsted County, Minnesota",59804,54948,364,50949,3635,4856
0500000US27111,27111,"Otter Tail County, Minnesota",24300,20251,514,16935,2802,4049
0500000US27113,27113,"Pennington County, Minnesota",5883,4853,15,4225,613,1030
0500000US27115,27115,"Pine County, Minnesota",10752,8515,168,6911,1436,2237
0500000US27117,27117,"Pipestone County, Minnesota",4019,3205,40,2770,395,814
0500000US27119,27119,"Polk County, Minnesota",12609,10489,72,9411,1006,2120
0500000US27121,27121,"Pope County, Minnesota",4898,4159,61,3577,521,739
0500000US27123,27123,"Ramsey County, Minnesota",208504,186735,1468,170138,15129,21769
0500000US27125,27125,"Red Lake County, Minnesota",1718,1381,20,1185,176,337
0500000US27127,27127,"Redwood County, Minnesota",6310,5183,118,4205,860,1127
0500000US27129,27129,"Renville County, Minnesota",6219,5061,93,3921,1047,1158
0500000US27131,27131,"Rice County, Minnesota",22899,20022,236,18250,1536,2877
0500000US27133,27133,"Rock County, Minnesota",3985,3428,45,3045,338,557
0500000US27135,27135,"Roseau County, Minnesota",6123,5081,85,3350,1646,1042
0500000US27137,27137,"St. Louis County, Minnesota",85662,72315,1032,62933,8350,13347
0500000US27139,27139,"Scott County, Minnesota",47864,44903,258,41794,2851,2961
0500000US27141,27141,"Sherburne County, Minnesota",31181,29150,302,26548,2300,2031
0500000US27143,27143,"Sibley County, Minnesota",5993,4979,116,4153,710,1014
0500000US27145,27145,"Stearns County, Minnesota",58657,52280,540,45831,5909,6377
0500000US27147,27147,"Steele County, Minnesota",14450,12439,105,11360,974,2011
0500000US27149,27149,"Stevens County, Minnesota",3630,3123,32,2718,373,507
0500000US27151,27151,"Swift County, Minnesota",4217,3376,77,2869,430,841
0500000US27153,27153,"Todd County, Minnesota",9777,7686,208,6535,943,2091
0500000US27155,27155,"Traverse County, Minnesota",1576,1258,26,1042,190,318
0500000US27157,27157,"Wabasha County, Minnesota",8867,7469,94,6687,688,1398
0500000US27159,27159,"Wadena County, Minnesota",5704,4540,101,3889,550,1164
0500000US27161,27161,"Waseca County, Minnesota",7375,6467,53,5774,640,908
0500000US27163,27163,"Washington County, Minnesota",92005,86374,562,81638,4174,5631
0500000US27165,27165,"Watonwan County, Minnesota",4327,3338,41,2704,593,989
0500000US27167,27167,"Wilkin County, Minnesota",2852,2316,22,2042,252,536
0500000US27169,27169,"Winona County, Minnesota",19228,16735,139,15230,1366,2493
0500000US27171,27171,"Wright County, Minnesota",46568,42651,426,38520,3705,3917
0500000US27173,27173,"Yellow Medicine County, Minnesota",4157,3458,61,3012,385,699
0500000US28001,28001,"Adams County, Mississippi",11509,8649,46,7626,977,2860
0500000US28003,28003,"Alcorn County, Mississippi",14675,11250,106,8552,2592,3425
0500000US28005,28005,"Amite County, Mississippi",4994,3161,35,2466,660,1833
0500000US28007,28007,"Attala County, Mississippi",7174,5376,34,4042,1300,1798
0500000US28009,28009,"Benton County, Mississippi",2960,2291,7,1555,729,669
0500000US28011,28011,"Bolivar County, Mississippi",12267,8667,78,6635,1954,3600
0500000US28013,28013,"Calhoun County, Mississippi",5853,4105,85,3026,994,1748
0500000US28015,28015,"Carroll County, Mississippi",3592,2577,30,2072,475,1015
0500000US28017,28017,"Chickasaw County, Mississippi",6454,4454,53,3248,1153,2000
0500000US28019,28019,"Choctaw County, Mississippi",3198,2232,42,1590,600,966
0500000US28021,28021,"Claiborne County, Mississippi",3187,2078,65,1738,275,1109
0500000US28023,28023,"Clarke County, Mississippi",6365,4508,65,3202,1241,1857
0500000US28025,28025,"Clay County, Mississippi",7681,5748,39,4580,1129,1933
0500000US28027,28027,"Coahoma County, Mississippi",8969,5944,140,4492,1312,3025
0500000US28029,28029,"Copiah County, Mississippi",9778,6558,92,4254,2212,3220
0500000US28031,28031,"Covington County, Mississippi",6919,5389,124,3563,1702,1530
0500000US28033,28033,"DeSoto County, Mississippi",61158,54351,247,48302,5802,6807
0500000US28035,28035,"Forrest County, Mississippi",28063,23828,135,19444,4249,4235
0500000US28037,28037,"Franklin County, Mississippi",3097,2453,54,2036,363,644
0500000US28039,28039,"George County, Mississippi",7220,5492,37,4365,1090,1728
0500000US28041,28041,"Greene County, Mississippi",4174,3179,50,2508,621,995
0500000US28043,28043,"Grenada County, Mississippi",7889,5863,9,4483,1371,2026
0500000US28045,28045,"Hancock County, Mississippi",19145,16225,42,13858,2325,2920
0500000US28047,28047,"Harrison County, Mississippi",77630,64610,282,57558,6770,13020
0500000US28049,28049,"Hinds County, Mississippi",89153,73379,269,61539,11571,15774
0500000US28051,28051,"Holmes County, Mississippi",6280,3798,30,2015,1753,2482
0500000US28053,28053,"Humphreys County, Mississippi",3119,2165,11,1600,554,954
0500000US28055,28055,"Issaquena County, Mississippi",437,257,0,215,42,180
0500000US28057,28057,"Itawamba County, Mississippi",8813,6954,104,5833,1017,1859
0500000US28059,28059,"Jackson County, Mississippi",50994,43212,409,36485,6318,7782
0500000US28061,28061,"Jasper County, Mississippi",6817,5004,116,3047,1841,1813
0500000US28063,28063,"Jefferson County, Mississippi",2453,1608,6,1373,229,845
0500000US28065,28065,"Jefferson Davis County, Mississippi",4798,3034,55,1886,1093,1764
0500000US28067,28067,"Jones County, Mississippi",24663,18539,400,11953,6186,6124
0500000US28069,28069,"Kemper County, Mississippi",3695,2298,45,1401,852,1397
0500000US28071,28071,"Lafayette County, Mississippi",19767,17702,36,14923,2743,2065
0500000US28073,28073,"Lamar County, Mississippi",22022,19673,166,17166,2341,2349
0500000US28075,28075,"Lauderdale County, Mississippi",29892,23258,154,17898,5206,6634
0500000US28077,28077,"Lawrence County, Mississippi",4822,3196,52,2132,1012,1626
0500000US28079,28079,"Leake County, Mississippi",8228,5803,32,4060,1711,2425
0500000US28081,28081,"Lee County, Mississippi",32485,26474,195,22262,4017,6011
0500000US28083,28083,"Leflore County, Mississippi",10477,6221,31,4066,2124,4256
0500000US28085,28085,"Lincoln County, Mississippi",12806,9207,45,6747,2415,3599
0500000US28087,28087,"Lowndes County, Mississippi",22630,18494,59,14331,4104,4136
0500000US28089,28089,"Madison County, Mississippi",38405,33930,265,29721,3944,4475
0500000US28091,28091,"Marion County, Mississippi",9667,6851,97,4755,1999,2816
0500000US28093,28093,"Marshall County, Mississippi",13084,9428,210,6286,2932,3656
0500000US28095,28095,"Monroe County, Mississippi",14042,9955,174,7718,2063,4087
0500000US28097,28097,"Montgomery County, Mississippi",4524,3226,36,2583,607,1298
0500000US28099,28099,"Neshoba County, Mississippi",10773,8230,93,6018,2119,2543
0500000US28101,28101,"Newton County, Mississippi",8010,6117,60,4498,1559,1893
0500000US28103,28103,"Noxubee County, Mississippi",4002,2605,12,1807,786,1397
0500000US28105,28105,"Oktibbeha County, Mississippi",17393,14735,118,12327,2290,2658
0500000US28107,28107,"Panola County, Mississippi",12449,8768,182,5941,2645,3681
0500000US28109,28109,"Pearl River County, Mississippi",20710,17211,112,14152,2947,3499
0500000US28111,28111,"Perry County, Mississippi",4476,3391,56,2593,742,1085
0500000US28113,28113,"Pike County, Mississippi",14962,10530,97,7033,3400,4432
0500000US28115,28115,"Pontotoc County, Mississippi",10845,8363,63,6079,2221,2482
0500000US28117,28117,"Prentiss County, Mississippi",9533,7045,94,5894,1057,2488
0500000US28119,28119,"Quitman County, Mississippi",3072,1996,21,1432,543,1076
0500000US28121,28121,"Rankin County, Mississippi",55226,49270,192,43998,5080,5956
0500000US28123,28123,"Scott County, Mississippi",10096,6988,31,4625,2332,3108
0500000US28125,28125,"Sharkey County, Mississippi",1809,1212,20,1090,102,597
0500000US28127,28127,"Simpson County, Mississippi",9322,6505,79,4841,1585,2817
0500000US28129,28129,"Smith County, Mississippi",5850,4187,64,2451,1672,1663
0500000US28131,28131,"Stone County, Mississippi",5979,4664,77,3804,783,1315
0500000US28133,28133,"Sunflower County, Mississippi",8505,6267,60,4528,1679,2238
0500000US28135,28135,"Tallahatchie County, Mississippi",4296,2804,14,1990,800,1492
0500000US28137,28137,"Tate County, Mississippi",10016,7920,72,6398,1450,2096
0500000US28139,28139,"Tippah County, Mississippi",8204,6242,52,4833,1357,1962
0500000US28141,28141,"Tishomingo County, Mississippi",7606,5853,107,4461,1285,1753
0500000US28143,28143,"Tunica County, Mississippi",3983,3242,29,2400,813,741
0500000US28145,28145,"Union County, Mississippi",9927,7734,94,6154,1486,2193
0500000US28147,28147,"Walthall County, Mississippi",5903,4112,101,2627,1384,1791
0500000US28149,28149,"Warren County, Mississippi",18559,14690,151,12864,1675,3869
0500000US28151,28151,"Washington County, Mississippi",18249,13546,34,10899,2613,4703
0500000US28153,28153,"Wayne County, Mississippi",7762,5713,16,4322,1375,2049
0500000US28155,28155,"Webster County, Mississippi",3842,2971,13,2267,691,871
0500000US28157,28157,"Wilkinson County, Mississippi",2882,1918,11,1308,599,964
0500000US28159,28159,"Winston County, Mississippi",7411,5232,64,4018,1150,2179
0500000US28161,28161,"Yalobusha County, Mississippi",5196,3510,43,2247,1220,1686
0500000US28163,28163,"Yazoo County, Mississippi",8642,5893,54,4355,1484,2749
0500000US29001,29001,"Adair County, Missouri",9595,8112,36,6946,1130,1483
0500000US29003,29003,"Andrew County, Missouri",6874,5795,104,5038,653,1079
0500000US29005,29005,"Atchison County, Missouri",2492,1959,12,1700,247,533
0500000US29007,29007,"Audrain County, Missouri",9457,7418,114,6384,920,2039
0500000US29009,29009,"Barry County, Missouri",13091,10321,148,7459,2714,2770
0500000US29011,29011,"Barton County, Missouri",4939,3631,54,2813,764,1308
0500000US29013,29013,"Bates County, Missouri",6704,5479,98,4527,854,1225
0500000US29015,29015,"Benton County, Missouri",7982,6115,191,4790,1134,1867
0500000US29017,29017,"Bollinger County, Missouri",4805,3658,71,2943,644,1147
0500000US29019,29019,"Boone County, Missouri",68898,63551,362,55993,7196,5347
0500000US29021,29021,"Buchanan County, Missouri",33304,27140,188,23559,3393,6164
0500000US29023,29023,"Butler County, Missouri",16550,13266,71,10871,2324,3284
0500000US29025,29025,"Caldwell County, Missouri",3741,2911,31,2477,403,830
0500000US29027,29027,"Callaway County, Missouri",16105,13304,143,10834,2327,2801
0500000US29029,29029,"Camden County, Missouri",16340,13899,290,11753,1856,2441
0500000US29031,29031,"Cape Girardeau County, Missouri",29613,25323,236,22628,2459,4290
0500000US29033,29033,"Carroll County, Missouri",3618,2825,40,2288,497,793
0500000US29035,29035,"Carter County, Missouri",2403,1847,17,1415,415,556
0500000US29037,29037,"Cass County, Missouri",38706,35187,290,31351,3546,3519
0500000US29039,29039,"Cedar County, Missouri",5879,4378,49,3725,604,1501
0500000US29041,29041,"Chariton County, Missouri",2842,2080,46,1805,229,762
0500000US29043,29043,"Christian County, Missouri",30774,27911,175,24153,3583,2863
0500000US29045,29045,"Clark County, Missouri",2907,2213,38,1923,252,694
0500000US29047,29047,"Clay County, Missouri",89709,82433,421,75186,6826,7276
0500000US29049,29049,"Clinton County, Missouri",8185,7148,91,6129,928,1037
0500000US29051,29051,"Cole County, Missouri",29642,25447,345,20187,4915,4195
0500000US29053,29053,"Cooper County, Missouri",6410,5344,37,4431,876,1066
0500000US29055,29055,"Crawford County, Missouri",9286,7001,136,5896,969,2285
0500000US29057,29057,"Dade County, Missouri",3107,2418,63,1946,409,689
0500000US29059,29059,"Dallas County, Missouri",6156,4745,48,3680,1017,1411
0500000US29061,29061,"Daviess County, Missouri",3083,2358,53,2077,228,725
0500000US29063,29063,"DeKalb County, Missouri",3854,2971,73,2551,347,883
0500000US29065,29065,"Dent County, Missouri",6087,4740,52,3950,738,1347
0500000US29067,29067,"Douglas County, Missouri",5173,3763,172,2798,793,1410
0500000US29069,29069,"Dunklin County, Missouri",12760,9690,54,7918,1718,3070
0500000US29071,29071,"Franklin County, Missouri",40612,35110,510,29657,4943,5502
0500000US29073,29073,"Gasconade County, Missouri",6135,5086,90,4345,651,1049
0500000US29075,29075,"Gentry County, Missouri",2662,2124,13,1916,195,538
0500000US29077,29077,"Greene County, Missouri",119989,104723,728,88129,15866,15266
0500000US29079,29079,"Grundy County, Missouri",4018,3035,60,2639,336,983
0500000US29081,29081,"Harrison County, Missouri",3528,2868,44,2524,300,660
0500000US29083,29083,"Henry County, Missouri",9294,7600,100,6332,1168,1694
0500000US29085,29085,"Hickory County, Missouri",3983,3017,121,2490,406,966
0500000US29087,29087,"Holt County, Missouri",2111,1682,29,1411,242,429
0500000US29089,29089,"Howard County, Missouri",3713,2987,85,2462,440,726
0500000US29091,29091,"Howell County, Missouri",16204,12740,199,10448,2093,3464
0500000US29093,29093,"Iron County, Missouri",4062,3119,36,2388,695,943
0500000US29095,29095,"Jackson County, Missouri",280174,239587,1224,211354,27009,40587
0500000US29097,29097,"Jasper County, Missouri",46009,38590,184,30812,7594,7419
0500000US29099,29099,"Jefferson County, Missouri",83744,74370,577,66300,7493,9374
0500000US29101,29101,"Johnson County, Missouri",19918,18128,158,16148,1822,1790
0500000US29103,29103,"Knox County, Missouri",1602,1217,14,954,249,385
0500000US29105,29105,"Laclede County, Missouri",13825,11053,125,8991,1937,2772
0500000US29107,29107,"Lafayette County, Missouri",13224,10866,150,9219,1497,2358
0500000US29109,29109,"Lawrence County, Missouri",14636,12037,148,10213,1676,2599
0500000US29111,29111,"Lewis County, Missouri",3754,3016,97,2571,348,738
0500000US29113,29113,"Lincoln County, Missouri",18698,16315,218,14164,1933,2383
0500000US29115,29115,"Linn County, Missouri",4997,3888,14,3350,524,1109
0500000US29117,29117,"Livingston County, Missouri",5813,4694,55,3836,803,1119
0500000US29119,29119,"McDonald County, Missouri",8137,6143,99,4144,1900,1994
0500000US29121,29121,"Macon County, Missouri",6023,4576,55,3820,701,1447
0500000US29123,29123,"Madison County, Missouri",4867,3664,44,3000,620,1203
0500000US29125,29125,"Maries County, Missouri",3667,2543,42,2076,425,1124
0500000US29127,29127,"Marion County, Missouri",11311,9394,90,8146,1158,1917
0500000US29129,29129,"Mercer County, Missouri",1390,989,9,888,92,401
0500000US29131,29131,"Miller County, Missouri",9514,7579,86,6109,1384,1935
0500000US29133,29133,"Mississippi County, Missouri",5128,3888,22,3290,576,1240
0500000US29135,29135,"Moniteau County, Missouri",5373,4221,78,3186,957,1152
0500000US29137,29137,"Monroe County, Missouri",3615,2738,26,2264,448,877
0500000US29139,29139,"Montgomery County, Missouri",4844,3706,63,2943,700,1138
0500000US29141,29141,"Morgan County, Missouri",7774,5862,69,4504,1289,1912
0500000US29143,29143,"New Madrid County, Missouri",7309,5573,11,4525,1037,1736
0500000US29145,29145,"Newton County, Missouri",22151,18050,233,14545,3272,4101
0500000US29147,29147,"Nodaway County, Missouri",8493,7375,146,6154,1075,1118
0500000US29149,29149,"Oregon County, Missouri",4375,3318,109,2293,916,1057
0500000US29151,29151,"Osage County, Missouri",5108,4092,73,3052,967,1016
0500000US29153,29153,"Ozark County, Missouri",4075,2928,95,2244,589,1147
0500000US29155,29155,"Pemiscot County, Missouri",6875,4780,11,4126,643,2095
0500000US29157,29157,"Perry County, Missouri",7529,6114,72,5347,695,1415
0500000US29159,29159,"Pettis County, Missouri",16031,13322,163,11353,1806,2709
0500000US29161,29161,"Phelps County, Missouri",17330,15012,208,13076,1728,2318
0500000US29163,29163,"Pike County, Missouri",6741,5276,152,4372,752,1465
0500000US29165,29165,"Platte County, Missouri",38147,35828,186,33172,2470,2319
0500000US29167,29167,"Polk County, Missouri",11717,9649,126,8337,1186,2068
0500000US29169,29169,"Pulaski County, Missouri",15375,13696,183,11830,1683,1679
0500000US29171,29171,"Putnam County, Missouri",1956,1569,7,1226,336,387
0500000US29173,29173,"Ralls County, Missouri",3994,3356,71,2954,331,638
0500000US29175,29175,"Randolph County, Missouri",8348,6694,77,5802,815,1654
0500000US29177,29177,"Ray County, Missouri",8684,7335,143,6115,1077,1349
0500000US29179,29179,"Reynolds County, Missouri",2628,2009,55,1658,296,619
0500000US29181,29181,"Ripley County, Missouri",5397,4201,25,3368,808,1196
0500000US29183,29183,"St. Charles County, Missouri",142554,132921,864,123085,8972,9633
0500000US29185,29185,"St. Clair County, Missouri",4135,2989,75,2467,447,1146
0500000US29186,29186,"Ste. Genevieve County, Missouri",7185,5903,117,4880,906,1282
0500000US29187,29187,"St. Francois County, Missouri",24661,19691,132,17447,2112,4970
0500000US29189,29189,"St. Louis County, Missouri",402307,360091,1823,329468,28800,42216
0500000US29195,29195,"Saline County, Missouri",8754,6970,80,6025,865,1784
0500000US29197,29197,"Schuyler County, Missouri",1669,1252,4,937,311,417
0500000US29199,29199,"Scotland County, Missouri",1870,1514,15,1278,221,356
0500000US29201,29201,"Scott County, Missouri",15241,12161,40,10692,1429,3080
0500000US29203,29203,"Shannon County, Missouri",3158,2142,97,1531,514,1016
0500000US29205,29205,"Shelby County, Missouri",2446,1956,19,1692,245,490
0500000US29207,29207,"Stoddard County, Missouri",11773,9540,22,8017,1501,2233
0500000US29209,29209,"Stone County, Missouri",12880,10941,219,9266,1456,1939
0500000US29211,29211,"Sullivan County, Missouri",2283,1662,45,1368,249,621
0500000US29213,29213,"Taney County, Missouri",22142,19408,221,16339,2848,2734
0500000US29215,29215,"Texas County, Missouri",9303,7135,187,5367,1581,2168
0500000US29217,29217,"Vernon County, Missouri",8170,6825,124,5804,897,1345
0500000US29219,29219,"Warren County, Missouri",12032,10203,209,8847,1147,1829
0500000US29221,29221,"Washington County, Missouri",9048,6822,139,5283,1400,2226
0500000US29223,29223,"Wayne County, Missouri",5482,4102,92,3324,686,1380
0500000US29225,29225,"Webster County, Missouri",13311,10480,156,8401,1923,2831
0500000US29227,29227,"Worth County, Missouri",888,678,4,597,77,210
0500000US29229,29229,"Wright County, Missouri",7488,5673,78,4557,1038,1815
0500000US29510,29510,"St. Louis city, Missouri",139741,112607,431,93560,18616,27134
0500000US30001,30001,"Beaverhead County, Montana",3978,3376,17,2854,505,602
0500000US30003,30003,"Big Horn County, Montana",3710,2719,39,2184,496,991
0500000US30005,30005,"Blaine County, Montana",2314,1764,0,1450,314,550
0500000US30007,30007,"Broadwater County, Montana",2405,1999,49,1626,324,406
0500000US30009,30009,"Carbon County, Montana",4565,3833,81,3238,514,732
0500000US30011,30011,"Carter County, Montana",565,430,6,397,27,135
0500000US30013,30013,"Cascade County, Montana",34383,27945,236,24867,2842,6438
0500000US30015,30015,"Chouteau County, Montana",2290,1774,48,1535,191,516
0500000US30017,30017,"Custer County, Montana",4875,4094,96,3646,352,781
0500000US30019,30019,"Daniels County, Montana",876,726,4,631,91,150
0500000US30021,30021,"Dawson County, Montana",4045,3482,21,3030,431,563
0500000US30023,30023,"Deer Lodge County, Montana",3984,3163,25,2779,359,821
0500000US30025,30025,"Fallon County, Montana",1241,1087,4,911,172,154
0500000US30027,30027,"Fergus County, Montana",4953,4150,123,3585,442,803
0500000US30029,30029,"Flathead County, Montana",38006,33328,407,30075,2846,4678
0500000US30031,30031,"Gallatin County, Montana",40723,38416,280,34591,3545,2307
0500000US30033,30033,"Garfield County, Montana",451,348,4,314,30,103
0500000US30035,30035,"Glacier County, Montana",4181,2646,27,2218,401,1535
0500000US30037,30037,"Golden Valley County, Montana",325,265,7,228,30,60
0500000US30039,30039,"Granite County, Montana",1309,1103,15,968,120,206
0500000US30041,30041,"Hill County, Montana",6208,5088,102,4341,645,1120
0500000US30043,30043,"Jefferson County, Montana",4512,3957,12,3496,449,555
0500000US30045,30045,"Judith Basin County, Montana",925,765,22,650,93,160
0500000US30047,30047,"Lake County, Montana",11796,9934,212,8006,1716,1862
0500000US30049,30049,"Lewis and Clark County, Montana",27534,24327,194,21473,2660,3207
0500000US30051,30051,"Liberty County, Montana",859,644,13,532,99,215
0500000US30053,30053,"Lincoln County, Montana",8244,6647,94,5669,884,1597
0500000US30055,30055,"McCone County, Montana",720,548,15,477,56,172
0500000US30057,30057,"Madison County, Montana",3487,2859,48,2341,470,628
0500000US30059,30059,"Meagher County, Montana",777,608,4,489,115,169
0500000US30061,30061,"Mineral County, Montana",1694,1335,33,1066,236,359
0500000US30063,30063,"Missoula County, Montana",47963,43890,301,38880,4709,4073
0500000US30065,30065,"Musselshell County, Montana",2073,1688,30,1521,137,385
0500000US30067,30067,"Park County, Montana",7552,6467,87,5592,788,1085
0500000US30069,30069,"Petroleum County, Montana",206,172,4,148,20,34
0500000US30071,30071,"Phillips County, Montana",1791,1421,26,1196,199,370
0500000US30073,30073,"Pondera County, Montana",2218,1718,8,1456,254,500
0500000US30075,30075,"Powder River County, Montana",764,652,46,524,82,112
0500000US30077,30077,"Powell County, Montana",2400,2000,27,1553,420,400
0500000US30079,30079,"Prairie County, Montana",549,424,15,379,30,125
0500000US30081,30081,"Ravalli County, Montana",16936,14734,272,12491,1971,2202
0500000US30083,30083,"Richland County, Montana",4523,3813,5,3312,496,710
0500000US30085,30085,"Roosevelt County, Montana",3203,2299,12,2063,224,904
0500000US30087,30087,"Rosebud County, Montana",3205,2438,361,1808,269,767
0500000US30089,30089,"Sanders County, Montana",4994,3740,76,3253,411,1254
0500000US30091,30091,"Sheridan County, Montana",1661,1446,25,1262,159,215
0500000US30093,30093,"Silver Bow County, Montana",15256,12372,123,10600,1649,2884
0500000US30095,30095,"Stillwater County, Montana",3797,3255,46,2899,310,542
0500000US30097,30097,"Sweet Grass County, Montana",1531,1221,18,1067,136,310
0500000US30099,30099,"Teton County, Montana",2413,2037,12,1725,300,376
0500000US30101,30101,"Toole County, Montana",1871,1534,34,1287,213,337
0500000US30103,30103,"Treasure County, Montana",365,315,23,235,57,50
0500000US30105,30105,"Valley County, Montana",3432,2901,42,2446,413,531
0500000US30107,30107,"Wheatland County, Montana",820,619,3,504,112,201
0500000US30109,30109,"Wibaux County, Montana",497,362,6,267,89,135
0500000US30111,30111,"Yellowstone County, Montana",64020,56914,557,51063,5294,7106
0500000US31001,31001,"Adams County, Nebraska",12659,10828,111,9534,1183,1831
0500000US31003,31003,"Antelope County, Nebraska",2748,2203,30,1917,256,545
0500000US31005,31005,"Arthur County, Nebraska",177,140,4,121,15,37
0500000US31007,31007,"Banner County, Nebraska",300,279,12,238,29,21
0500000US31009,31009,"Blaine County, Nebraska",232,203,0,182,21,29
0500000US31011,31011,"Boone County, Nebraska",2277,1872,12,1693,167,405
0500000US31013,31013,"Box Butte County, Nebraska",4610,3844,3,3520,321,766
0500000US31015,31015,"Boyd County, Nebraska",905,683,2,585,96,222
0500000US31017,31017,"Brown County, Nebraska",1475,1141,6,990,145,334
0500000US31019,31019,"Buffalo County, Nebraska",18923,16817,126,15027,1664,2106
0500000US31021,31021,"Burt County, Nebraska",2885,2220,30,1861,329,665
0500000US31023,31023,"Butler County, Nebraska",3400,2755,52,2410,293,645
0500000US31025,31025,"Cass County, Nebraska",9894,8965,95,8091,779,929
0500000US31027,31027,"Cedar County, Nebraska",3508,2879,38,2587,254,629
0500000US31029,31029,"Chase County, Nebraska",1671,1383,0,1252,131,288
0500000US31031,31031,"Cherry County, Nebraska",2652,2169,3,1990,176,483
0500000US31033,31033,"Cheyenne County, Nebraska",4400,3772,37,3203,532,628
0500000US31035,31035,"Clay County, Nebraska",2616,2226,27,1924,275,390
0500000US31037,31037,"Colfax County, Nebraska",3681,2871,30,2502,339,810
0500000US31039,31039,"Cuming County, Nebraska",3790,2965,79,2431,455,825
0500000US31041,31041,"Custer County, Nebraska",4792,3826,42,3085,699,966
0500000US31043,31043,"Dakota County, Nebraska",7427,6460,39,5358,1063,967
0500000US31045,31045,"Dawes County, Nebraska",3557,2826,41,2459,326,731
0500000US31047,31047,"Dawson County, Nebraska",8898,7550,108,6444,998,1348
0500000US31049,31049,"Deuel County, Nebraska",833,705,15,570,120,128
0500000US31051,31051,"Dixon County, Nebraska",2307,1904,20,1600,284,403
0500000US31053,31053,"Dodge County, Nebraska",15090,12857,111,11129,1617,2233
0500000US31055,31055,"Douglas County, Nebraska",213689,186486,1025,170298,15163,27203
0500000US31057,31057,"Dundy County, Nebraska",875,709,3,633,73,166
0500000US31059,31059,"Fillmore County, Nebraska",2443,1991,31,1715,245,452
0500000US31061,31061,"Franklin County, Nebraska",1367,1107,13,952,142,260
0500000US31063,31063,"Frontier County, Nebraska",1113,889,7,748,134,224
0500000US31065,31065,"Furnas County, Nebraska",2172,1733,14,1521,198,439
0500000US31067,31067,"Gage County, Nebraska",9255,7651,86,6841,724,1604
0500000US31069,31069,"Garden County, Nebraska",897,741,5,611,125,156
0500000US31071,31071,"Garfield County, Nebraska",893,695,0,541,154,198
0500000US31073,31073,"Gosper County, Nebraska",885,729,3,652,74,156
0500000US31075,31075,"Grant County, Nebraska",274,215,1,196,18,59
0500000US31077,31077,"Greeley County, Nebraska",1015,793,15,644,134,222
0500000US31079,31079,"Hall County, Nebraska",22817,19028,167,17084,1777,3789
0500000US31081,31081,"Hamilton County, Nebraska",3722,3302,58,2937,307,420
0500000US31083,31083,"Harlan County, Nebraska",1590,1284,16,1163,105,306
0500000US31085,31085,"Hayes County, Nebraska",423,346,4,307,35,77
0500000US31087,31087,"Hitchcock County, Nebraska",1273,974,43,790,141,299
0500000US31089,31089,"Holt County, Nebraska",4569,3745,69,3022,654,824
0500000US31091,31091,"Hooker County, Nebraska",316,238,0,193,45,78
0500000US31093,31093,"Howard County, Nebraska",2656,2166,70,1846,250,490
0500000US31095,31095,"Jefferson County, Nebraska",3308,2577,53,2253,271,731
0500000US31097,31097,"Johnson County, Nebraska",1869,1424,28,1271,125,445
0500000US31099,31099,"Kearney County, Nebraska",2745,2335,21,2062,252,410
0500000US31101,31101,"Keith County, Nebraska",3989,3389,28,3066,295,600
0500000US31103,31103,"Keya Paha County, Nebraska",334,284,6,260,18,50
0500000US31105,31105,"Kimball County, Nebraska",1546,1296,19,1081,196,250
0500000US31107,31107,"Knox County, Nebraska",3662,2837,55,2391,391,825
0500000US31109,31109,"Lancaster County, Nebraska",120962,110636,521,101031,9084,10326
0500000US31111,31111,"Lincoln County, Nebraska",15025,12853,144,11239,1470,2172
0500000US31113,31113,"Logan County, Nebraska",366,294,5,243,46,72
0500000US31115,31115,"Loup County, Nebraska",245,190,1,165,24,55
0500000US31117,31117,"McPherson County, Nebraska",192,141,0,117,24,51
0500000US31119,31119,"Madison County, Nebraska",14236,12072,265,10245,1562,2164
0500000US31121,31121,"Merrick County, Nebraska",3251,2653,41,2196,416,598
0500000US31123,31123,"Morrill County, Nebraska",2017,1646,15,1399,232,371
0500000US31125,31125,"Nance County, Nebraska",1553,1201,5,1083,113,352
0500000US31127,31127,"Nemaha County, Nebraska",2814,2347,70,1937,340,467
0500000US31129,31129,"Nuckolls County, Nebraska",1985,1636,45,1393,198,349
0500000US31131,31131,"Otoe County, Nebraska",6439,5377,74,4663,640,1062
0500000US31133,31133,"Pawnee County, Nebraska",1238,894,20,806,68,344
0500000US31135,31135,"Perkins County, Nebraska",1247,1107,3,1013,91,140
0500000US31137,31137,"Phelps County, Nebraska",3870,3370,19,2940,411,500
0500000US31139,31139,"Pierce County, Nebraska",2985,2463,26,2198,239,522
0500000US31141,31141,"Platte County, Nebraska",12937,10788,164,9685,939,2149
0500000US31143,31143,"Polk County, Nebraska",2038,1752,25,1605,122,286
0500000US31145,31145,"Red Willow County, Nebraska",4598,3838,64,3230,544,760
0500000US31147,31147,"Richardson County, Nebraska",3798,2978,6,2687,285,820
0500000US31149,31149,"Rock County, Nebraska",655,515,7,448,60,140
0500000US31151,31151,"Saline County, Nebraska",5073,4154,65,3629,460,919
0500000US31153,31153,"Sarpy County, Nebraska",63851,60028,216,56288,3524,3823
0500000US31155,31155,"Saunders County, Nebraska",8150,6946,84,6103,759,1204
0500000US31157,31157,"Scotts Bluff County, Nebraska",14425,12046,133,10608,1305,2379
0500000US31159,31159,"Seward County, Nebraska",6496,5674,99,4971,604,822
0500000US31161,31161,"Sheridan County, Nebraska",2306,1703,44,1467,192,603
0500000US31163,31163,"Sherman County, Nebraska",1378,1115,23,947,145,263
0500000US31165,31165,"Sioux County, Nebraska",579,462,7,382,73,117
0500000US31167,31167,"Stanton County, Nebraska",2351,1987,50,1735,202,364
0500000US31169,31169,"Thayer County, Nebraska",2337,1902,39,1711,152,435
0500000US31171,31171,"Thomas County, Nebraska",293,241,0,227,14,52
0500000US31173,31173,"Thurston County, Nebraska",2142,1650,61,1251,338,492
0500000US31175,31175,"Valley County, Nebraska",1934,1517,2,1256,259,417
0500000US31177,31177,"Washington County, Nebraska",8133,7228,154,6296,778,905
0500000US31179,31179,"Wayne County, Nebraska",3602,3263,20,2878,365,339
0500000US31181,31181,"Webster County, Nebraska",1499,1208,26,1022,160,291
0500000US31183,31183,"Wheeler County, Nebraska",378,308,11,257,40,70
0500000US31185,31185,"York County, Nebraska",5623,4860,125,4283,452,763
0500000US32001,32001,"Churchill County, Nevada",9734,8569,140,7579,850,1165
0500000US32003,32003,"Clark County, Nevada",749858,675431,3671,591068,80692,74427
0500000US32005,32005,"Douglas County, Nevada",20376,18572,214,17154,1204,1804
0500000US32007,32007,"Elko County, Nevada",17882,16339,111,14482,1746,1543
0500000US32009,32009,"Esmeralda County, Nevada",494,420,9,285,126,74
0500000US32011,32011,"Eureka County, Nevada",765,632,16,553,63,133
0500000US32013,32013,"Humboldt County, Nevada",6261,5219,38,4448,733,1042
0500000US32015,32015,"Lander County, Nevada",2183,1802,20,1465,317,381
0500000US32017,32017,"Lincoln County, Nevada",1930,1585,9,1434,142,345
0500000US32019,32019,"Lyon County, Nevada",20127,17557,129,15798,1630,2570
0500000US32021,32021,"Mineral County, Nevada",1859,1432,0,1232,200,427
0500000US32023,32023,"Nye County, Nevada",18077,15483,347,12832,2304,2594
0500000US32027,32027,"Pershing County, Nevada",2018,1531,22,1254,255,487
0500000US32029,32029,"Storey County, Nevada",1665,1453,5,1309,139,212
0500000US32031,32031,"Washoe County, Nevada",173519,155791,816,139306,15669,17728
0500000US32033,32033,"White Pine County, Nevada",3343,2777,45,2415,317,566
0500000US32510,32510,"Carson City, Nevada",22158,19299,138,17100,2061,2859
0500000US33001,33001,"Belknap County, New Hampshire",24579,21964,164,20079,1721,2615
0500000US33003,33003,"Carroll County, New Hampshire",21203,19157,142,17318,1697,2046
0500000US33005,33005,"Cheshire County, New Hampshire",30529,27188,295,24559,2334,3341
0500000US33007,33007,"Coos County, New Hampshire",13879,11676,174,10097,1405,2203
0500000US33009,33009,"Grafton County, New Hampshire",34856,31353,368,27787,3198,3503
0500000US33011,33011,"Hillsborough County, New Hampshire",158139,146272,649,136805,8818,11867
0500000US33013,33013,"Merrimack County, New Hampshire",57247,51232,393,47239,3600,6015
0500000US33015,33015,"Rockingham County, New Hampshire",119955,111761,301,105342,6118,8194
0500000US33017,33017,"Strafford County, New Hampshire",48543,44276,283,40027,3966,4267
0500000US33019,33019,"Sullivan County, New Hampshire",17780,15568,95,13738,1735,2212
0500000US34001,34001,"Atlantic County, New Jersey",100660,87766,715,78020,9031,12894
0500000US34003,34003,"Bergen County, New Jersey",337819,308080,1305,293367,13408,29739
0500000US34005,34005,"Burlington County, New Jersey",164404,150197,799,141155,8243,14207
0500000US34007,34007,"Camden County, New Jersey",187012,163424,650,149361,13413,23588
0500000US34009,34009,"Cape May County, New Jersey",39861,34783,275,31541,2967,5078
0500000US34011,34011,"Cumberland County, New Jersey",50596,40915,260,35554,5101,9681
0500000US34013,34013,"Essex County, New Jersey",280327,240072,999,210262,28811,40255
0500000US34015,34015,"Gloucester County, New Jersey",104810,95149,417,87892,6840,9661
0500000US34017,34017,"Hudson County, New Jersey",252352,222875,819,203846,18210,29477
0500000US34019,34019,"Hunterdon County, New Jersey",46822,43413,355,41131,1927,3409
0500000US34021,34021,"Mercer County, New Jersey",129546,114825,499,103506,10820,14721
0500000US34023,34023,"Middlesex County, New Jersey",283794,255577,1358,235063,19156,28217
0500000US34025,34025,"Monmouth County, New Jersey",232482,212137,850,198825,12462,20345
0500000US34027,34027,"Morris County, New Jersey",180124,167630,660,159936,7034,12494
0500000US34029,34029,"Ocean County, New Jersey",223135,193111,1367,174985,16759,30024
0500000US34031,34031,"Passaic County, New Jersey",162440,135795,598,123261,11936,26645
0500000US34033,34033,"Salem County, New Jersey",24038,20087,332,17587,2168,3951
0500000US34035,34035,"Somerset County, New Jersey",115970,107810,498,103178,4134,8160
0500000US34037,34037,"Sussex County, New Jersey",53618,49480,405,46090,2985,4138
0500000US34039,34039,"Union County, New Jersey",187916,164231,921,147934,15376,23685
0500000US34041,34041,"Warren County, New Jersey",41385,37024,388,34053,2583,4361
0500000US35001,35001,"Bernalillo County, New Mexico",263551,228226,1919,198249,28058,35325
0500000US35003,35003,"Catron County, New Mexico",1433,998,0,784,214,435
0500000US35005,35005,"Chaves County, New Mexico",23343,18763,123,15664,2976,4580
0500000US35006,35006,"Cibola County, New Mexico",9068,6663,128,4655,1880,2405
0500000US35007,35007,"Colfax County, New Mexico",5591,4190,76,3473,641,1401
0500000US35009,35009,"Curry County, New Mexico",18470,15774,80,13513,2181,2696
0500000US35011,35011,"De Baca County, New Mexico",666,513,0,432,81,153
0500000US35013,35013,"Doña Ana County, New Mexico",76740,63712,384,53470,9858,13028
0500000US35015,35015,"Eddy County, New Mexico",21273,17867,88,16056,1723,3406
0500000US35017,35017,"Grant County, New Mexico",11879,9560,100,7708,1752,2319
0500000US35019,35019,"Guadalupe County, New Mexico",1253,547,16,396,135,706
0500000US35021,35021,"Harding County, New Mexico",203,117,0,96,21,86
0500000US35023,35023,"Hidalgo County, New Mexico",1761,1264,15,1035,214,497
0500000US35025,35025,"Lea County, New Mexico",22029,18107,89,16094,1924,3922
0500000US35027,35027,"Lincoln County, New Mexico",7902,6180,69,5107,1004,1722
0500000US35028,35028,"Los Alamos County, New Mexico",7525,6917,70,6484,363,608
0500000US35029,35029,"Luna County, New Mexico",9088,6374,95,4616,1663,2714
0500000US35031,35031,"McKinley County, New Mexico",19764,10850,195,7541,3114,8914
0500000US35033,35033,"Mora County, New Mexico",1513,842,0,683,159,671
0500000US35035,35035,"Otero County, New Mexico",23657,19472,134,17147,2191,4185
0500000US35037,35037,"Quay County, New Mexico",3085,2095,42,1707,346,990
0500000US35039,35039,"Rio Arriba County, New Mexico",12852,7533,184,6057,1292,5319
0500000US35041,35041,"Roosevelt County, New Mexico",7125,5805,11,5005,789,1320
0500000US35043,35043,"Sandoval County, New Mexico",49265,42973,581,38293,4099,6292
0500000US35045,35045,"San Juan County, New Mexico",41999,31352,586,24187,6579,10647
0500000US35047,35047,"San Miguel County, New Mexico",11041,7162,10,5150,2002,3879
0500000US35049,35049,"Santa Fe County, New Mexico",61651,52806,517,46650,5639,8845
0500000US35051,35051,"Sierra County, New Mexico",5400,3953,78,3114,761,1447
0500000US35053,35053,"Socorro County, New Mexico",4698,3132,76,2525,531,1566
0500000US35055,35055,"Taos County, New Mexico",12603,9413,199,7082,2132,3190
0500000US35057,35057,"Torrance County, New Mexico",5598,4427,74,3306,1047,1171
0500000US35059,35059,"Union County, New Mexico",1424,968,6,784,178,456
0500000US35061,35061,"Valencia County, New Mexico",26985,20624,285,16795,3544,6361
0500000US36001,36001,"Albany County, New York",125376,110111,607,100311,9193,15265
0500000US36003,36003,"Allegany County, New York",18124,14594,275,12418,1901,3530
0500000US36005,36005,"Bronx County, New York",495356,407946,1475,340202,66269,87410
0500000US36007,36007,"Broome County, New York",78821,67416,613,60558,6245,11405
0500000US36009,36009,"Cattaraugus County, New York",31723,25412,408,20960,4044,6311
0500000US36011,36011,"Cayuga County, New York",31428,26281,246,23116,2919,5147
0500000US36013,36013,"Chautauqua County, New York",52983,43671,453,37524,5694,9312
0500000US36015,36015,"Chemung County, New York",34664,29719,235,25826,3658,4945
0500000US36017,36017,"Chenango County, New York",20373,17167,144,15163,1860,3206
0500000US36019,36019,"Clinton County, New York",31680,27238,184,23882,3172,4442
0500000US36021,36021,"Columbia County, New York",25470,21894,225,19015,2654,3576
0500000US36023,36023,"Cortland County, New York",17925,14834,164,12521,2149,3091
0500000US36025,36025,"Delaware County, New York",19098,15654,175,13648,1831,3444
0500000US36027,36027,"Dutchess County, New York",107384,96693,578,89721,6394,10691
0500000US36029,36029,"Erie County, New York",386371,327125,2094,291079,33952,59246
0500000US36031,36031,"Essex County, New York",15257,12953,126,11388,1439,2304
0500000US36033,36033,"Franklin County, New York",18956,15323,199,13231,1893,3633
0500000US36035,36035,"Fulton County, New York",22535,18866,140,16410,2316,3669
0500000US36037,36037,"Genesee County, New York",23951,20150,142,17859,2149,3801
0500000US36039,36039,"Greene County, New York",17106,14210,199,12208,1803,2896
0500000US36041,36041,"Hamilton County, New York",1095,909,14,791,104,186
0500000US36043,36043,"Herkimer County, New York",25187,20803,313,18234,2256,4384
0500000US36045,36045,"Jefferson County, New York",43206,38624,168,34605,3851,4582
0500000US36047,36047,"Kings County, New York",944650,794464,3770,702185,88509,150186
0500000US36049,36049,"Lewis County, New York",10236,8458,148,7348,962,1778
0500000US36051,36051,"Livingston County, New York",24432,21316,268,19100,1948,3116
0500000US36053,36053,"Madison County, New York",26307,22460,181,20548,1731,3847
0500000US36055,36055,"Monroe County, New York",300496,260431,1676,236400,22355,40065
0500000US36057,36057,"Montgomery County, New York",19700,15967,238,14013,1716,3733
0500000US36059,36059,"Nassau County, New York",444136,407036,1200,385495,20341,37100
0500000US36061,36061,"New York County, New York",758345,675852,2324,616595,56933,82493
0500000US36063,36063,"Niagara County, New York",87978,72337,1216,63631,7490,15641
0500000US36065,36065,"Oneida County, New York",90472,76085,582,67926,7577,14387
0500000US36067,36067,"Onondaga County, New York",185840,160523,721,143285,16517,25317
0500000US36069,36069,"Ontario County, New York",44269,39104,273,35453,3378,5165
0500000US36071,36071,"Orange County, New York",126460,111245,457,94934,15854,15215
0500000US36073,36073,"Orleans County, New York",16214,13491,90,11966,1435,2723
0500000US36075,36075,"Oswego County, New York",45881,40439,224,36264,3951,5442
0500000US36077,36077,"Otsego County, New York",23627,20363,348,17735,2280,3264
0500000US36079,36079,"Putnam County, New York",34316,32265,85,30772,1408,2051
0500000US36081,36081,"Queens County, New York",777904,676122,2983,614802,58337,101782
0500000US36083,36083,"Rensselaer County, New York",64456,56917,303,51897,4717,7539
0500000US36085,36085,"Richmond County, New York",166150,144890,580,131554,12756,21260
0500000US36087,36087,"Rockland County, New York",99935,86817,366,77824,8627,13118
0500000US36089,36089,"St. Lawrence County, New York",41638,35181,283,31177,3721,6457
0500000US36091,36091,"Saratoga County, New York",93129,85079,352,79371,5356,8050
0500000US36093,36093,"Schenectady County, New York",53825,47034,162,42844,4028,6791
0500000US36095,36095,"Schoharie County, New York",12539,10416,214,8874,1328,2123
0500000US36097,36097,"Schuyler County, New York",7444,6200,73,5336,791,1244
0500000US36099,36099,"Seneca County, New York",13536,11573,127,10173,1273,1963
0500000US36101,36101,"Steuben County, New York",40351,33491,478,28607,4406,6860
0500000US36103,36103,"Suffolk County, New York",489328,444858,1450,416004,27404,44470
0500000US36105,36105,"Sullivan County, New York",27679,22954,221,20905,1828,4725
0500000US36107,36107,"Tioga County, New York",19996,16967,199,15260,1508,3029
0500000US36109,36109,"Tompkins County, New York",38986,35763,280,32017,3466,3223
0500000US36111,36111,"Ulster County, New York",69662,61455,430,56347,4678,8207
0500000US36113,36113,"Warren County, New York",27249,23804,228,21955,1621,3445
0500000US36115,36115,"Washington County, New York",23988,20079,311,17490,2278,3909
0500000US36117,36117,"Wayne County, New York",36578,30639,324,26427,3888,5939
0500000US36119,36119,"Westchester County, New York",345885,311280,970,285807,24503,34605
0500000US36121,36121,"Wyoming County, New York",15686,13138,231,11378,1529,2548
0500000US36123,36123,"Yates County, New York",9338,7407,93,6426,888,1931
0500000US37001,37001,"Alamance County, North Carolina",63035,53724,255,45836,7633,9311
0500000US37003,37003,"Alexander County, North Carolina",13744,10504,163,9085,1256,3240
0500000US37005,37005,"Alleghany County, North Carolina",4742,3672,6,3242,424,1070
0500000US37007,37007,"Anson County, North Carolina",9647,7228,118,5870,1240,2419
0500000US37009,37009,"Ashe County, North Carolina",11995,9095,92,7863,1140,2900
0500000US37011,37011,"Avery County, North Carolina",6725,5107,40,4132,935,1618
0500000US37013,37013,"Beaufort County, North Carolina",18978,14081,199,11441,2441,4897
0500000US37015,37015,"Bertie County, North Carolina",7988,5325,110,4109,1106,2663
0500000US37017,37017,"Bladen County, North Carolina",14394,10790,145,8569,2076,3604
0500000US37019,37019,"Brunswick County, North Carolina",53104,47391,475,40931,5985,5713
0500000US37021,37021,"Buncombe County, North Carolina",105407,91047,338,82779,7930,14360
0500000US37023,37023,"Burke County, North Carolina",34568,26383,332,22534,3517,8185
0500000US37025,37025,"Cabarrus County, North Carolina",70598,64315,422,59888,4005,6283
0500000US37027,37027,"Caldwell County, North Carolina",32150,25534,355,22433,2746,6616
0500000US37029,37029,"Camden County, North Carolina",3796,3322,25,2996,301,474
0500000US37031,37031,"Carteret County, North Carolina",30000,26669,225,23683,2761,3331
0500000US37033,37033,"Caswell County, North Carolina",9160,6745,119,5532,1094,2415
0500000US37035,37035,"Catawba County, North Carolina",60238,50396,271,44919,5206,9842
0500000US37037,37037,"Chatham County, North Carolina",28148,24180,284,21298,2598,3968
0500000US37039,37039,"Cherokee County, North Carolina",11206,8704,122,7294,1288,2502
0500000US37041,37041,"Chowan County, North Carolina",5903,4599,81,3673,845,1304
0500000US37043,37043,"Clay County, North Carolina",5049,4269,51,3692,526,780
0500000US37045,37045,"Cleveland County, North Carolina",37782,27706,199,22981,4526,10076
0500000US37047,37047,"Columbus County, North Carolina",22462,15990,208,12799,2983,6472
0500000US37049,37049,"Craven County, North Carolina",40571,35623,181,31570,3872,4948
0500000US37051,37051,"Cumberland County, North Carolina",124500,109909,508,97212,12189,14591
0500000US37053,37053,"Currituck County, North Carolina",9766,8759,96,7765,898,1007
0500000US37055,37055,"Dare County, North Carolina",15264,14165,134,12847,1184,1099
0500000US37057,37057,"Davidson County, North Carolina",64727,53354,430,46753,6171,11373
0500000US37059,37059,"Davie County, North Carolina",15895,13503,169,12153,1181,2392
0500000US37061,37061,"Duplin County, North Carolina",21669,16377,73,12357,3947,5292
0500000US37063,37063,"Durham County, North Carolina",120936,109274,409,100350,8515,11662
0500000US37065,37065,"Edgecombe County, North Carolina",21431,15517,121,12213,3183,5914
0500000US37067,37067,"Forsyth County, North Carolina",145102,125787,745,112431,12611,19315
0500000US37069,37069,"Franklin County, North Carolina",24287,20082,122,17358,2602,4205
0500000US37071,37071,"Gaston County, North Carolina",80682,66813,361,59578,6874,13869
0500000US37073,37073,"Gates County, North Carolina",4439,3419,68,2790,561,1020
0500000US37075,37075,"Graham County, North Carolina",3303,2037,40,1619,378,1266
0500000US37077,37077,"Granville County, North Carolina",20945,17563,105,15098,2360,3382
0500000US37079,37079,"Greene County, North Carolina",7348,5870,117,5045,708,1478
0500000US37081,37081,"Guilford County, North Carolina",200998,170099,1006,141273,27820,30899
0500000US37083,37083,"Halifax County, North Carolina",21207,15563,105,11787,3671,5644
0500000US37085,37085,"Harnett County, North Carolina",44657,39069,293,33312,5464,5588
0500000US37087,37087,"Haywood County, North Carolina",26288,21282,131,17617,3534,5006
0500000US37089,37089,"Henderson County, North Carolina",47804,40763,209,36371,4183,7041
0500000US37091,37091,"Hertford County, North Carolina",8880,6487,92,4983,1412,2393
0500000US37093,37093,"Hoke County, North Carolina",17373,14631,116,13011,1504,2742
0500000US37095,37095,"Hyde County, North Carolina",1835,1329,91,872,366,506
0500000US37097,37097,"Iredell County, North Carolina",63447,55411,402,48625,6384,8036
0500000US37099,37099,"Jackson County, North Carolina",16218,13236,211,10416,2609,2982
0500000US37101,37101,"Johnston County, North Carolina",65401,57473,489,48763,8221,7928
0500000US37103,37103,"Jones County, North Carolina",4148,3025,27,2272,726,1123
0500000US37105,37105,"Lee County, North Carolina",21691,17911,141,15558,2212,3780
0500000US37107,37107,"Lenoir County, North Carolina",23263,18434,219,16396,1819,4829
0500000US37109,37109,"Lincoln County, North Carolina",31250,26099,155,23271,2673,5151
0500000US37111,37111,"McDowell County, North Carolina",17970,14297,221,12012,2064,3673
0500000US37113,37113,"Macon County, North Carolina",15513,12356,177,10426,1753,3157
0500000US37115,37115,"Madison County, North Carolina",8346,6429,55,5519,855,1917
0500000US37117,37117,"Martin County, North Carolina",9624,7142,110,5513,1519,2482
0500000US37119,37119,"Mecklenburg County, North Carolina",395503,363416,1224,331350,30842,32087
0500000US37121,37121,"Mitchell County, North Carolina",6390,4801,46,3972,783,1589
0500000US37123,37123,"Montgomery County, North Carolina",10855,7835,85,6583,1167,3020
0500000US37125,37125,"Moore County, North Carolina",38185,32376,209,29733,2434,5809
0500000US37127,37127,"Nash County, North Carolina",36878,29483,416,25180,3887,7395
0500000US37129,37129,"New Hanover County, North Carolina",91673,82244,367,73664,8213,9429
0500000US37131,37131,"Northampton County, North Carolina",8819,5994,26,4541,1427,2825
0500000US37133,37133,"Onslow County, North Carolina",63093,57834,225,52147,5462,5259
0500000US37135,37135,"Orange County, North Carolina",52160,48567,238,45092,3237,3593
0500000US37137,37137,"Pamlico County, North Carolina",5395,4477,75,3667,735,918
0500000US37139,37139,"Pasquotank County, North Carolina",14629,11877,103,9926,1848,2752
0500000US37141,37141,"Pender County, North Carolina",21053,18063,215,14901,2947,2990
0500000US37143,37143,"Perquimans County, North Carolina",5882,4711,104,3946,661,1171
0500000US37145,37145,"Person County, North Carolina",15772,12497,111,10862,1524,3275
0500000US37147,37147,"Pitt County, North Carolina",68805,59393,349,51716,7328,9412
0500000US37149,37149,"Polk County, North Carolina",8913,7472,116,6522,834,1441
0500000US37151,37151,"Randolph County, North Carolina",55679,44524,475,37835,6214,11155
0500000US37153,37153,"Richmond County, North Carolina",18371,13632,90,11731,1811,4739
0500000US37155,37155,"Robeson County, North Carolina",46163,31153,181,22737,8235,15010
0500000US37157,37157,"Rockingham County, North Carolina",37162,28841,230,24488,4123,8321
0500000US37159,37159,"Rowan County, North Carolina",51798,43274,399,37587,5288,8524
0500000US37161,37161,"Rutherford County, North Carolina",26497,20022,269,16546,3207,6475
0500000US37163,37163,"Sampson County, North Carolina",23431,17814,136,13518,4160,5617
0500000US37165,37165,"Scotland County, North Carolina",13273,9628,109,7171,2348,3645
0500000US37167,37167,"Stanly County, North Carolina",23859,19781,195,17261,2325,4078
0500000US37169,37169,"Stokes County, North Carolina",19273,15182,356,12837,1989,4091
0500000US37171,37171,"Surry County, North Carolina",29256,22020,337,17966,3717,7236
0500000US37173,37173,"Swain County, North Carolina",5464,3319,81,2416,822,2145
0500000US37175,37175,"Transylvania County, North Carolina",14125,12360,64,10495,1801,1765
0500000US37177,37177,"Tyrrell County, North Carolina",1539,1044,9,841,194,495
0500000US37179,37179,"Union County, North Carolina",73709,67992,314,63862,3816,5717
0500000US37181,37181,"Vance County, North Carolina",17029,12905,90,10291,2524,4124
0500000US37183,37183,"Wake County, North Carolina",381971,361448,1099,335687,24662,20523
0500000US37185,37185,"Warren County, North Carolina",8157,5900,100,4350,1450,2257
0500000US37187,37187,"Washington County, North Carolina",5223,3621,24,2880,717,1602
0500000US37189,37189,"Watauga County, North Carolina",20331,17834,129,15926,1779,2497
0500000US37191,37191,"Wayne County, North Carolina",47587,39544,164,34310,5070,8043
0500000US37193,37193,"Wilkes County, North Carolina",27765,21639,207,18355,3077,6126
0500000US37195,37195,"Wilson County, North Carolina",32068,25898,178,22608,3112,6170
0500000US37197,37197,"Yadkin County, North Carolina",15521,11867,108,10083,1676,3654
0500000US37199,37199,"Yancey County, North Carolina",7493,5336,27,4402,907,2157
0500000US38001,38001,"Adams County, North Dakota",1052,876,0,791,85,176
0500000US38003,38003,"Barnes County, North Dakota",5113,4256,42,3661,553,857
0500000US38005,38005,"Benson County, North Dakota",2292,1658,10,1244,404,634
0500000US38007,38007,"Billings County, North Dakota",401,304,11,259,34,97
0500000US38009,38009,"Bottineau County, North Dakota",3096,2639,30,2348,261,457
0500000US38011,38011,"Bowman County, North Dakota",1432,1262,6,1078,178,170
0500000US38013,38013,"Burke County, North Dakota",950,801,4,647,150,149
0500000US38015,38015,"Burleigh County, North Dakota",38901,34405,167,31089,3149,4496
0500000US38017,38017,"Cass County, North Dakota",73039,66467,268,59755,6444,6572
0500000US38019,38019,"Cavalier County, North Dakota",1787,1495,11,1388,96,292
0500000US38021,38021,"Dickey County, North Dakota",2192,1946,20,1700,226,246
0500000US38023,38023,"Divide County, North Dakota",1053,812,16,663,133,241
0500000US38025,38025,"Dunn County, North Dakota",1601,1355,4,1191,160,246
0500000US38027,38027,"Eddy County, North Dakota",1048,795,6,681,108,253
0500000US38029,38029,"Emmons County, North Dakota",1565,1120,9,845,266,445
0500000US38031,38031,"Foster County, North Dakota",1502,1248,39,1104,105,254
0500000US38033,38033,"Golden Valley County, North Dakota",863,666,3,564,99,197
0500000US38035,38035,"Grand Forks County, North Dakota",29716,26596,213,23413,2970,3120
0500000US38037,38037,"Grant County, North Dakota",1110,855,7,748,100,255
0500000US38039,38039,"Griggs County, North Dakota",1039,797,8,691,98,242
0500000US38041,38041,"Hettinger County, North Dakota",1078,842,0,737,105,236
0500000US38043,38043,"Kidder County, North Dakota",1053,822,2,678,142,231
0500000US38045,38045,"LaMoure County, North Dakota",1811,1439,15,1237,187,372
0500000US38047,38047,"Logan County, North Dakota",879,715,0,588,127,164
0500000US38049,38049,"McHenry County, North Dakota",2663,2178,41,2004,133,485
0500000US38051,38051,"McIntosh County, North Dakota",1325,1017,20,813,184,308
0500000US38053,38053,"McKenzie County, North Dakota",3651,3360,36,2807,517,291
0500000US38055,38055,"McLean County, North Dakota",4313,3673,28,2708,937,640
0500000US38057,38057,"Mercer County, North Dakota",3649,3082,5,2788,289,567
0500000US38059,38059,"Morton County, North Dakota",13246,11590,130,10052,1408,1656
0500000US38061,38061,"Mountrail County, North Dakota",3213,2684,9,2141,534,529
0500000US38063,38063,"Nelson County, North Dakota",1492,1209,9,1004,196,283
0500000US38065,38065,"Oliver County, North Dakota",788,658,0,576,82,130
0500000US38067,38067,"Pembina County, North Dakota",3218,2540,22,2206,312,678
0500000US38069,38069,"Pierce County, North Dakota",1995,1551,3,1447,101,444
0500000US38071,38071,"Ramsey County, North Dakota",4931,4046,42,3450,554,885
0500000US38073,38073,"Ransom County, North Dakota",2333,1936,16,1693,227,397
0500000US38075,38075,"Renville County, North Dakota",1011,855,11,735,109,156
0500000US38077,38077,"Richland County, North Dakota",6829,5827,71,4985,771,1002
0500000US38079,38079,"Rolette County, North Dakota",4740,3570,29,2995,546,1170
0500000US38081,38081,"Sargent County, North Dakota",1819,1564,15,1408,141,255
0500000US38083,38083,"Sheridan County, North Dakota",684,536,6,426,104,148
0500000US38085,38085,"Sioux County, North Dakota",1114,761,21,599,141,353
0500000US38087,38087,"Slope County, North Dakota",309,223,5,205,13,86
0500000US38089,38089,"Stark County, North Dakota",11962,10379,49,9223,1107,1583
0500000US38091,38091,"Steele County, North Dakota",916,776,12,694,70,140
0500000US38093,38093,"Stutsman County, North Dakota",9199,7884,36,6595,1253,1315
0500000US38095,38095,"Towner County, North Dakota",1033,831,20,703,108,202
0500000US38097,38097,"Traill County, North Dakota",3349,2848,7,2568,273,501
0500000US38099,38099,"Walsh County, North Dakota",4838,3769,27,3275,467,1069
0500000US38101,38101,"Ward County, North Dakota",27449,24942,152,23132,1658,2507
0500000US38103,38103,"Wells County, North Dakota",1988,1564,7,1423,134,424
0500000US38105,38105,"Williams County, North Dakota",12895,11846,35,9702,2109,1049
0500000US39001,39001,"Adams County, Ohio",10829,7758,293,5856,1609,3071
0500000US39003,39003,"Allen County, Ohio",40319,34059,292,29478,4289,6260
0500000US39005,39005,"Ashland County, Ohio",20504,17049,157,15266,1626,3455
0500000US39007,39007,"Ashtabula County, Ohio",38381,30831,307,27321,3203,7550
0500000US39009,39009,"Athens County, Ohio",22509,19071,247,15748,3076,3438
0500000US39011,39011,"Auglaize County, Ohio",18342,16009,155,14640,1214,2333
0500000US39013,39013,"Belmont County, Ohio",26910,21444,267,18448,2729,5466
0500000US39015,39015,"Brown County, Ohio",17333,14258,210,11868,2180,3075
0500000US39017,39017,"Butler County, Ohio",136416,121589,591,111322,9676,14827
0500000US39019,39019,"Carroll County, Ohio",10917,8847,219,7532,1096,2070
0500000US39021,39021,"Champaign County, Ohio",15274,13370,91,12134,1145,1904
0500000US39023,39023,"Clark County, Ohio",54836,46328,212,41418,4698,8508
0500000US39025,39025,"Clermont County, Ohio",76143,68131,592,61546,5993,8012
0500000US39027,39027,"Clinton County, Ohio",16309,13719,207,11829,1683,2590
0500000US39029,39029,"Columbiana County, Ohio",41582,34540,380,29636,4524,7042
0500000US39031,39031,"Coshocton County, Ohio",14367,11171,170,9405,1596,3196
0500000US39033,39033,"Crawford County, Ohio",17833,14530,234,12801,1495,3303
0500000US39035,39035,"Cuyahoga County, Ohio",537621,450008,2633,396822,50553,87613
0500000US39037,39037,"Darke County, Ohio",20803,17158,245,14788,2125,3645
0500000US39039,39039,"Defiance County, Ohio",15309,13107,268,11733,1106,2202
0500000US39041,39041,"Delaware County, Ohio",67701,64397,308,61090,2999,3304
0500000US39043,39043,"Erie County, Ohio",31577,26976,181,24088,2707,4601
0500000US39045,39045,"Fairfield County, Ohio",55549,49607,429,45000,4178,5942
0500000US39047,39047,"Fayette County, Ohio",11729,9424,47,7775,1602,2305
0500000US39049,39049,"Franklin County, Ohio",496337,447655,1717,408773,37165,48682
0500000US39051,39051,"Fulton County, Ohio",16404,14361,209,12699,1453,2043
0500000US39053,39053,"Gallia County, Ohio",11520,8938,195,7323,1420,2582
0500000US39055,39055,"Geauga County, Ohio",35121,30178,212,27858,2108,4943
0500000US39057,39057,"Greene County, Ohio",64702,58242,297,53049,4896,6460
0500000US39059,39059,"Guernsey County, Ohio",16065,12774,177,11135,1462,3291
0500000US39061,39061,"Hamilton County, Ohio",338267,291569,2351,260774,28444,46698
0500000US39063,39063,"Hancock County, Ohio",32049,28470,297,25262,2911,3579
0500000US39065,39065,"Hardin County, Ohio",11430,9032,84,7840,1108,2398
0500000US39067,39067,"Harrison County, Ohio",6192,4783,60,4212,511,1409
0500000US39069,39069,"Henry County, Ohio",11094,9704,145,8591,968,1390
0500000US39071,39071,"Highland County, Ohio",16731,12981,131,10549,2301,3750
0500000US39073,39073,"Hocking County, Ohio",11268,9171,202,7698,1271,2097
0500000US39075,39075,"Holmes County, Ohio",12520,7901,105,6445,1351,4619
0500000US39077,39077,"Huron County, Ohio",22876,19452,354,16979,2119,3424
0500000US39079,39079,"Jackson County, Ohio",12964,10531,162,8628,1741,2433
0500000US39081,39081,"Jefferson County, Ohio",27571,21864,221,19509,2134,5707
0500000US39083,39083,"Knox County, Ohio",23229,19228,256,17105,1867,4001
0500000US39085,39085,"Lake County, Ohio",95238,83749,530,77873,5346,11489
0500000US39087,39087,"Lawrence County, Ohio",23731,18474,315,15616,2543,5257
0500000US39089,39089,"Licking County, Ohio",64434,56903,494,51871,4538,7531
0500000US39091,39091,"Logan County, Ohio",18627,15854,98,14062,1694,2773
0500000US39093,39093,"Lorain County, Ohio",118594,102786,851,91593,10342,15808
0500000US39095,39095,"Lucas County, Ohio",178971,154944,777,134100,20067,24027
0500000US39097,39097,"Madison County, Ohio",14916,12886,60,11475,1351,2030
0500000US39099,39099,"Mahoning County, Ohio",98035,80800,587,71087,9126,17235
0500000US39101,39101,"Marion County, Ohio",24699,20706,163,18011,2532,3993
0500000US39103,39103,"Medina County, Ohio",67192,61420,410,56908,4102,5772
0500000US39105,39105,"Meigs County, Ohio",9285,7201,93,5826,1282,2084
0500000US39107,39107,"Mercer County, Ohio",16142,13998,130,12750,1118,2144
0500000US39109,39109,"Miami County, Ohio",40900,35277,282,31956,3039,5623
0500000US39111,39111,"Monroe County, Ohio",5984,4367,108,3594,665,1617
0500000US39113,39113,"Montgomery County, Ohio",223495,192401,1290,172192,18919,31094
0500000US39115,39115,"Morgan County, Ohio",6116,4714,220,3815,679,1402
0500000US39117,39117,"Morrow County, Ohio",12781,10730,196,9134,1400,2051
0500000US39119,39119,"Muskingum County, Ohio",34348,28550,323,24701,3526,5798
0500000US39121,39121,"Noble County, Ohio",5012,3367,29,2937,401,1645
0500000US39123,39123,"Ottawa County, Ohio",17495,15414,256,13399,1759,2081
0500000US39125,39125,"Paulding County, Ohio",7589,6110,60,5325,725,1479
0500000US39127,39127,"Perry County, Ohio",13576,10853,235,8834,1784,2723
0500000US39129,39129,"Pickaway County, Ohio",19465,16594,164,14887,1543,2871
0500000US39131,39131,"Pike County, Ohio",11033,8642,67,7169,1406,2391
0500000US39133,39133,"Portage County, Ohio",62208,55080,507,48113,6460,7128
0500000US39135,39135,"Preble County, Ohio",16126,13635,164,11940,1531,2491
0500000US39137,39137,"Putnam County, Ohio",13159,11342,102,10106,1134,1817
0500000US39139,39139,"Richland County, Ohio",47987,39267,316,33380,5571,8720
0500000US39141,39141,"Ross County, Ohio",28526,23829,193,20429,3207,4697
0500000US39143,39143,"Sandusky County, Ohio",23721,19917,165,16795,2957,3804
0500000US39145,39145,"Scioto County, Ohio",30204,23166,513,19893,2760,7038
0500000US39147,39147,"Seneca County, Ohio",21507,18172,204,15736,2232,3335
0500000US39149,39149,"Shelby County, Ohio",18665,15873,155,13854,1864,2792
0500000US39151,39151,"Stark County, Ohio",152037,129576,719,118689,10168,22461
0500000US39153,39153,"Summit County, Ohio",223021,191383,1449,171532,18402,31638
0500000US39155,39155,"Trumbull County, Ohio",86709,70127,713,60553,8861,16582
0500000US39157,39157,"Tuscarawas County, Ohio",36548,29110,295,25420,3395,7438
0500000US39159,39159,"Union County, Ohio",19038,17029,174,15890,965,2009
0500000US39161,39161,"Van Wert County, Ohio",11503,9845,175,8220,1450,1658
0500000US39163,39163,"Vinton County, Ohio",5053,3679,47,2725,907,1374
0500000US39165,39165,"Warren County, Ohio",80704,74722,189,70866,3667,5982
0500000US39167,39167,"Washington County, Ohio",25378,19681,329,16955,2397,5697
0500000US39169,39169,"Wayne County, Ohio",43353,35954,276,32254,3424,7399
0500000US39171,39171,"Williams County, Ohio",15263,12859,156,11445,1258,2404
0500000US39173,39173,"Wood County, Ohio",50187,45190,477,40527,4186,4997
0500000US39175,39175,"Wyandot County, Ohio",9157,7623,84,6469,1070,1534
0500000US40001,40001,"Adair County, Oklahoma",7796,5416,91,3779,1546,2380
0500000US40003,40003,"Alfalfa County, Oklahoma",1978,1645,21,1450,174,333
0500000US40005,40005,"Atoka County, Oklahoma",5284,4100,77,3369,654,1184
0500000US40007,40007,"Beaver County, Oklahoma",2103,1696,17,1475,204,407
0500000US40009,40009,"Beckham County, Oklahoma",7573,6388,26,5440,922,1185
0500000US40011,40011,"Blaine County, Oklahoma",3819,2950,38,2265,647,869
0500000US40013,40013,"Bryan County, Oklahoma",16911,13916,107,11024,2785,2995
0500000US40015,40015,"Caddo County, Oklahoma",10273,7847,54,5775,2018,2426
0500000US40017,40017,"Canadian County, Oklahoma",43878,40262,162,35821,4279,3616
0500000US40019,40019,"Carter County, Oklahoma",18278,14908,72,11020,3816,3370
0500000US40021,40021,"Cherokee County, Oklahoma",16360,12416,136,9503,2777,3944
0500000US40023,40023,"Choctaw County, Oklahoma",5962,3882,26,3132,724,2080
0500000US40025,40025,"Cimarron County, Oklahoma",990,810,0,618,192,180
0500000US40027,40027,"Cleveland County, Oklahoma",103028,95296,521,86638,8137,7732
0500000US40029,40029,"Coal County, Oklahoma",2240,1624,22,1342,260,616
0500000US40031,40031,"Comanche County, Oklahoma",42957,37731,182,32721,4828,5226
0500000US40033,40033,"Cotton County, Oklahoma",2265,1826,34,1486,306,439
0500000US40035,40035,"Craig County, Oklahoma",5413,4158,46,3257,855,1255
0500000US40037,40037,"Creek County, Oklahoma",26398,21171,137,18855,2179,5227
0500000US40039,40039,"Custer County, Oklahoma",10458,9219,61,7736,1422,1239
0500000US40041,40041,"Delaware County, Oklahoma",16571,13519,110,10868,2541,3052
0500000US40043,40043,"Dewey County, Oklahoma",1727,1415,9,1096,310,312
0500000US40045,40045,"Ellis County, Oklahoma",1625,1291,30,993,268,334
0500000US40047,40047,"Garfield County, Oklahoma",23798,19993,102,17372,2519,3805
0500000US40049,40049,"Garvin County, Oklahoma",10473,8321,90,6927,1304,2152
0500000US40051,40051,"Grady County, Oklahoma",19743,16585,159,12621,3805,3158
0500000US40053,40053,"Grant County, Oklahoma",1883,1524,16,1285,223,359
0500000US40055,40055,"Greer County, Oklahoma",2152,1690,18,1484,188,462
0500000US40057,40057,"Harmon County, Oklahoma",1185,941,10,798,133,244
0500000US40059,40059,"Harper County, Oklahoma",1348,1102,1,851,250,246
0500000US40061,40061,"Haskell County, Oklahoma",4849,3612,16,2882,714,1237
0500000US40063,40063,"Hughes County, Oklahoma",4258,2816,165,2157,494,1442
0500000US40065,40065,"Jackson County, Oklahoma",9958,8304,41,7339,924,1654
0500000US40067,40067,"Jefferson County, Oklahoma",2392,1724,16,1308,400,668
0500000US40069,40069,"Johnston County, Oklahoma",4256,3211,43,2461,707,1045
0500000US40071,40071,"Kay County, Oklahoma",17890,14736,112,11076,3548,3154
0500000US40073,40073,"Kingfisher County, Oklahoma",5691,4782,95,3674,1013,909
0500000US40075,40075,"Kiowa County, Oklahoma",3839,3030,7,2576,447,809
0500000US40077,40077,"Latimer County, Oklahoma",4019,3047,55,2355,637,972
0500000US40079,40079,"Le Flore County, Oklahoma",18354,13450,135,11184,2131,4904
0500000US40081,40081,"Lincoln County, Oklahoma",12923,10179,210,7641,2328,2744
0500000US40083,40083,"Logan County, Oklahoma",15651,13091,77,11481,1533,2560
0500000US40085,40085,"Love County, Oklahoma",3104,2535,16,1892,627,569
0500000US40087,40087,"McClain County, Oklahoma",13838,12293,59,10958,1276,1545
0500000US40089,40089,"McCurtain County, Oklahoma",12980,8507,69,6815,1623,4473
0500000US40091,40091,"McIntosh County, Oklahoma",8349,6403,114,4666,1623,1946
0500000US40093,40093,"Major County, Oklahoma",3030,2403,40,1986,377,627
0500000US40095,40095,"Marshall County, Oklahoma",6241,5091,34,3539,1518,1150
0500000US40097,40097,"Mayes County, Oklahoma",15730,12986,109,10751,2126,2744
0500000US40099,40099,"Murray County, Oklahoma",5275,4453,29,3368,1056,822
0500000US40101,40101,"Muskogee County, Oklahoma",26097,20648,148,16162,4338,5449
0500000US40103,40103,"Noble County, Oklahoma",4598,3694,19,2971,704,904
0500000US40105,40105,"Nowata County, Oklahoma",4064,3185,29,2379,777,879
0500000US40107,40107,"Okfuskee County, Oklahoma",3987,2865,31,2286,548,1122
0500000US40109,40109,"Oklahoma County, Oklahoma",296818,259899,1096,226434,32369,36919
0500000US40111,40111,"Okmulgee County, Oklahoma",14852,11477,121,9079,2277,3375
0500000US40113,40113,"Osage County, Oklahoma",18314,14903,129,12156,2618,3411
0500000US40115,40115,"Ottawa County, Oklahoma",12020,8908,82,7061,1765,3112
0500000US40117,40117,"Pawnee County, Oklahoma",6211,4827,52,3642,1133,1384
0500000US40119,40119,"Payne County, Oklahoma",30404,26932,135,23689,3108,3472
0500000US40121,40121,"Pittsburg County, Oklahoma",17828,14160,82,11823,2255,3668
0500000US40123,40123,"Pontotoc County, Oklahoma",14512,11557,309,9232,2016,2955
0500000US40125,40125,"Pottawatomie County, Oklahoma",25925,21453,218,17024,4211,4472
0500000US40127,40127,"Pushmataha County, Oklahoma",4550,3262,19,2703,540,1288
0500000US40129,40129,"Roger Mills County, Oklahoma",1350,1104,16,824,264,246
0500000US40131,40131,"Rogers County, Oklahoma",34109,30521,181,25607,4733,3588
0500000US40133,40133,"Seminole County, Oklahoma",9240,7099,140,5423,1536,2141
0500000US40135,40135,"Sequoyah County, Oklahoma",15412,12205,165,9665,2375,3207
0500000US40137,40137,"Stephens County, Oklahoma",17252,14115,180,11493,2442,3137
0500000US40139,40139,"Texas County, Oklahoma",6989,5397,41,4260,1096,1592
0500000US40141,40141,"Tillman County, Oklahoma",3012,2319,23,1933,363,693
0500000US40143,40143,"Tulsa County, Oklahoma",250071,220166,833,195635,23698,29905
0500000US40145,40145,"Wagoner County, Oklahoma",28309,25652,142,23087,2423,2657
0500000US40147,40147,"Washington County, Oklahoma",20688,17435,113,15169,2153,3253
0500000US40149,40149,"Washita County, Oklahoma",4484,3870,58,2988,824,614
0500000US40151,40151,"Woods County, Oklahoma",3413,2874,29,2472,373,539
0500000US40153,40153,"Woodward County, Oklahoma",7366,6394,56,5361,977,972
0500000US41001,41001,"Baker County, Oregon",7033,5854,93,4881,880,1179
0500000US41003,41003,"Benton County, Oregon",34775,32929,233,30240,2456,1846
0500000US41005,41005,"Clackamas County, Oregon",153822,142055,986,130759,10310,11767
0500000US41007,41007,"Clatsop County, Oregon",15976,14121,36,12711,1374,1855
0500000US41009,41009,"Columbia County, Oregon",19213,16938,192,15558,1188,2275
0500000US41011,41011,"Coos County, Oregon",26473,22017,286,18383,3348,4456
0500000US41013,41013,"Crook County, Oregon",9330,8128,55,7222,851,1202
0500000US41015,41015,"Curry County, Oregon",10382,8646,115,7458,1073,1736
0500000US41017,41017,"Deschutes County, Oregon",69631,64977,402,57603,6972,4654
0500000US41019,41019,"Douglas County, Oregon",44828,38653,692,33673,4288,6175
0500000US41021,41021,"Gilliam County, Oregon",805,642,24,540,78,163
0500000US41023,41023,"Grant County, Oregon",3176,2658,33,2314,311,518
0500000US41025,41025,"Harney County, Oregon",3079,2580,27,2159,394,499
0500000US41027,41027,"Hood River County, Oregon",8543,7687,121,6640,926,856
0500000US41029,41029,"Jackson County, Oregon",86195,76724,610,69611,6503,9471
0500000US41031,41031,"Jefferson County, Oregon",7628,6534,20,5739,775,1094
0500000US41033,41033,"Josephine County, Oregon",35614,30578,515,27086,2977,5036
0500000US41035,41035,"Klamath County, Oregon",27171,23034,168,20004,2862,4137
0500000US41037,41037,"Lake County, Oregon",3522,2761,2,2183,576,761
0500000US41039,41039,"Lane County, Oregon",148752,135268,1246,119282,14740,13484
0500000US41041,41041,"Lincoln County, Oregon",20674,17986,234,15758,1994,2688
0500000US41043,41043,"Linn County, Oregon",46265,40841,277,36019,4545,5424
0500000US41045,41045,"Malheur County, Oregon",10262,8379,127,6810,1442,1883
0500000US41047,41047,"Marion County, Oregon",116077,103842,871,93503,9468,12235
0500000US41049,41049,"Morrow County, Oregon",3936,3337,38,2836,463,599
0500000US41051,41051,"Multnomah County, Oregon",318173,291926,1488,266305,24133,26247
0500000US41053,41053,"Polk County, Oregon",29128,26618,342,23926,2350,2510
0500000US41055,41055,"Sherman County, Oregon",779,680,8,590,82,99
0500000US41057,41057,"Tillamook County, Oregon",10454,8968,110,7764,1094,1486
0500000US41059,41059,"Umatilla County, Oregon",26976,23062,135,20109,2818,3914
0500000US41061,41061,"Union County, Oregon",10291,8876,102,7683,1091,1415
0500000US41063,41063,"Wallowa County, Oregon",3126,2624,13,2253,358,502
0500000US41065,41065,"Wasco County, Oregon",10135,8607,166,7317,1124,1528
0500000US41067,41067,"Washington County, Oregon",212778,201361,735,186341,14285,11417
0500000US41069,41069,"Wheeler County, Oregon",677,535,1,466,68,142
0500000US41071,41071,"Yamhill County, Oregon",35952,32588,332,29071,3185,3364
0500000US42001,42001,"Adams County, Pennsylvania",38818,33415,528,29510,3377,5403
0500000US42003,42003,"Allegheny County, Pennsylvania",536439,461787,2797,420004,38986,74652
0500000US42005,42005,"Armstrong County, Pennsylvania",28242,22528,413,20154,1961,5714
0500000US42007,42007,"Beaver County, Pennsylvania",70384,58162,526,53089,4547,12222
0500000US42009,42009,"Bedford County, Pennsylvania",19666,15084,310,13401,1373,4582
0500000US42011,42011,"Berks County, Pennsylvania",153876,131525,1618,119947,9960,22351
0500000US42013,42013,"Blair County, Pennsylvania",51638,41367,334,36901,4132,10271
0500000US42015,42015,"Bradford County, Pennsylvania",24851,20468,414,18142,1912,4383
0500000US42017,42017,"Bucks County, Pennsylvania",235909,214310,944,202277,11089,21599
0500000US42019,42019,"Butler County, Pennsylvania",75596,66073,493,61086,4494,9523
0500000US42021,42021,"Cambria County, Pennsylvania",57154,45201,634,40644,3923,11953
0500000US42023,42023,"Cameron County, Pennsylvania",2196,1718,16,1575,127,478
0500000US42025,42025,"Carbon County, Pennsylvania",25978,21702,317,19269,2116,4276
0500000US42027,42027,"Centre County, Pennsylvania",57710,52010,519,46567,4924,5700
0500000US42029,42029,"Chester County, Pennsylvania",188613,171972,604,161832,9536,16641
0500000US42031,42031,"Clarion County, Pennsylvania",15925,12962,209,11585,1168,2963
0500000US42033,42033,"Clearfield County, Pennsylvania",31152,24305,432,21011,2862,6847
0500000US42035,42035,"Clinton County, Pennsylvania",14675,11985,236,10464,1285,2690
0500000US42037,42037,"Columbia County, Pennsylvania",26564,21678,248,19342,2088,4886
0500000US42039,42039,"Crawford County, Pennsylvania",35102,28588,442,25251,2895,6514
0500000US42041,42041,"Cumberland County, Pennsylvania",97919,85777,757,78465,6555,12142
0500000US42043,42043,"Dauphin County, Pennsylvania",111489,95695,745,86306,8644,15794
0500000US42045,42045,"Delaware County, Pennsylvania",204870,181832,887,166946,13999,23038
0500000US42047,42047,"Elk County, Pennsylvania",13447,10923,180,9880,863,2524
0500000US42049,42049,"Erie County, Pennsylvania",110377,93898,1025,83724,9149,16479
0500000US42051,42051,"Fayette County, Pennsylvania",54043,41035,436,36336,4263,13008
0500000US42053,42053,"Forest County, Pennsylvania",1473,1079,40,881,158,394
0500000US42055,42055,"Franklin County, Pennsylvania",60102,49672,887,44637,4148,10430
0500000US42057,42057,"Fulton County, Pennsylvania",5947,4568,101,3932,535,1379
0500000US42059,42059,"Greene County, Pennsylvania",14484,11802,99,10535,1168,2682
0500000US42061,42061,"Huntingdon County, Pennsylvania",16935,13566,208,11801,1557,3369
0500000US42063,42063,"Indiana County, Pennsylvania",34030,26918,483,23525,2910,7112
0500000US42065,42065,"Jefferson County, Pennsylvania",18452,14243,175,12738,1330,4209
0500000US42067,42067,"Juniata County, Pennsylvania",9361,7194,154,6291,749,2167
0500000US42069,42069,"Lackawanna County, Pennsylvania",85907,70068,823,62432,6813,15839
0500000US42071,42071,"Lancaster County, Pennsylvania",198565,166816,1909,147421,17486,31749
0500000US42073,42073,"Lawrence County, Pennsylvania",36742,29483,488,25758,3237,7259
0500000US42075,42075,"Lebanon County, Pennsylvania",52792,44286,356,39588,4342,8506
0500000US42077,42077,"Lehigh County, Pennsylvania",137239,118724,1170,107145,10409,18515
0500000US42079,42079,"Luzerne County, Pennsylvania",128247,103654,1465,91345,10844,24593
0500000US42081,42081,"Lycoming County, Pennsylvania",45991,38209,586,33103,4520,7782
0500000US42083,42083,"McKean County, Pennsylvania",17199,14168,184,12059,1925,3031
0500000US42085,42085,"Mercer County, Pennsylvania",45805,37385,492,33101,3792,8420
0500000US42087,42087,"Mifflin County, Pennsylvania",18939,14433,405,11934,2094,4506
0500000US42089,42089,"Monroe County, Pennsylvania",57526,51112,487,46054,4571,6414
0500000US42091,42091,"Montgomery County, Pennsylvania",312805,284943,1402,269221,14320,27862
0500000US42093,42093,"Montour County, Pennsylvania",7423,6055,81,5382,592,1368
0500000US42095,42095,"Northampton County, Pennsylvania",113827,98227,912,89045,8270,15600
0500000US42097,42097,"Northumberland County, Pennsylvania",39281,30186,452,26511,3223,9095
0500000US42099,42099,"Perry County, Pennsylvania",17936,14734,286,13001,1447,3202
0500000US42101,42101,"Philadelphia County, Pennsylvania",591280,480881,3009,406285,71587,110399
0500000US42103,42103,"Pike County, Pennsylvania",21379,19322,157,17912,1253,2057
0500000US42105,42105,"Potter County, Pennsylvania",6536,5145,84,4540,521,1391
0500000US42107,42107,"Schuylkill County, Pennsylvania",58758,46620,605,41430,4585,12138
0500000US42109,42109,"Snyder County, Pennsylvania",14576,11597,176,10213,1208,2979
0500000US42111,42111,"Somerset County, Pennsylvania",29918,23204,353,20063,2788,6714
0500000US42113,42113,"Sullivan County, Pennsylvania",2648,2078,58,1782,238,570
0500000US42115,42115,"Susquehanna County, Pennsylvania",17404,14758,195,13096,1467,2646
0500000US42117,42117,"Tioga County, Pennsylvania",16121,13233,320,11577,1336,2888
0500000US42119,42119,"Union County, Pennsylvania",14702,11802,118,10289,1395,2900
0500000US42121,42121,"Venango County, Pennsylvania",21925,17915,282,15840,1793,4010
0500000US42123,42123,"Warren County, Pennsylvania",17095,14052,307,11919,1826,3043
0500000US42125,42125,"Washington County, Pennsylvania",83897,70814,689,64291,5834,13083
0500000US42127,42127,"Wayne County, Pennsylvania",19202,16049,456,14195,1398,3153
0500000US42129,42129,"Westmoreland County, Pennsylvania",151892,125279,1538,112414,11327,26613
0500000US42131,42131,"Wyoming County, Pennsylvania",10801,9149,135,8435,579,1652
0500000US42133,42133,"York County, Pennsylvania",169667,145081,1711,128692,14678,24586
0500000US44001,44001,"Bristol County, Rhode Island",19521,17102,155,15882,1065,2419
0500000US44003,44003,"Kent County, Rhode Island",69013,60938,168,57098,3672,8075
0500000US44005,44005,"Newport County, Rhode Island",35421,31612,212,29041,2359,3809
0500000US44007,44007,"Providence County, Rhode Island",238465,201526,1034,182875,17617,36939
0500000US44009,44009,"Washington County, Rhode Island",49608,44716,124,42125,2467,4892
0500000US45001,45001,"Abbeville County, South Carolina",9392,7006,40,5801,1165,2386
0500000US45003,45003,"Aiken County, South Carolina",65703,55267,639,47273,7355,10436
0500000US45005,45005,"Allendale County, South Carolina",3285,2107,28,1320,759,1178
0500000US45007,45007,"Anderson County, South Carolina",76234,62214,259,52220,9735,14020
0500000US45009,45009,"Bamberg County, South Carolina",5587,3935,67,2916,952,1652
0500000US45011,45011,"Barnwell County, South Carolina",8426,5940,59,4463,1418,2486
0500000US45013,45013,"Beaufort County, South Carolina",68790,62779,560,56380,5839,6011
0500000US45015,45015,"Berkeley County, South Carolina",73168,65572,435,57076,8061,7596
0500000US45017,45017,"Calhoun County, South Carolina",6150,4478,55,3743,680,1672
0500000US45019,45019,"Charleston County, South Carolina",154049,136889,470,114261,22158,17160
0500000US45021,45021,"Cherokee County, South Carolina",20480,15123,112,11887,3124,5357
0500000US45023,45023,"Chester County, South Carolina",12384,8693,166,6369,2158,3691
0500000US45025,45025,"Chesterfield County, South Carolina",18303,13507,82,10491,2934,4796
0500000US45027,45027,"Clarendon County, South Carolina",13573,10115,75,8125,1915,3458
0500000US45029,45029,"Colleton County, South Carolina",15134,12314,125,11022,1167,2820
0500000US45031,45031,"Darlington County, South Carolina",26861,19996,159,16948,2889,6865
0500000US45033,45033,"Dillon County, South Carolina",10945,7662,33,5322,2307,3283
0500000US45035,45035,"Dorchester County, South Carolina",54028,47888,217,41768,5903,6140
0500000US45037,45037,"Edgefield County, South Carolina",9054,6996,155,5643,1198,2058
0500000US45039,45039,"Fairfield County, South Carolina",8878,6420,77,4347,1996,2458
0500000US45041,45041,"Florence County, South Carolina",52092,41554,234,35406,5914,10538
0500000US45043,45043,"Georgetown County, South Carolina",24840,20674,74,17378,3222,4166
0500000US45045,45045,"Greenville County, South Carolina",185837,158684,706,141338,16640,27153
0500000US45047,45047,"Greenwood County, South Carolina",27022,21708,213,17473,4022,5314
0500000US45049,45049,"Hampton County, South Carolina",7129,5138,56,4299,783,1991
0500000US45051,45051,"Horry County, South Carolina",125168,111225,677,98709,11839,13943
0500000US45053,45053,"Jasper County, South Carolina",9715,7389,85,5861,1443,2326
0500000US45055,45055,"Kershaw County, South Carolina",24711,20056,272,15654,4130,4655
0500000US45057,45057,"Lancaster County, South Carolina",31445,25827,201,22623,3003,5618
0500000US45059,45059,"Laurens County, South Carolina",25543,20118,195,16301,3622,5425
0500000US45061,45061,"Lee County, South Carolina",6501,4491,110,3091,1290,2010
0500000US45063,45063,"Lexington County, South Carolina",109251,96466,608,84418,11440,12785
0500000US45065,45065,"McCormick County, South Carolina",4077,3142,12,2659,471,935
0500000US45067,45067,"Marion County, South Carolina",11911,8338,109,5371,2858,3573
0500000US45069,45069,"Marlboro County, South Carolina",9703,6796,134,5108,1554,2907
0500000US45071,45071,"Newberry County, South Carolina",14893,10863,186,8682,1995,4030
0500000US45073,45073,"Oconee County, South Carolina",31354,25626,222,21495,3909,5728
0500000US45075,45075,"Orangeburg County, South Carolina",33029,23791,347,19240,4204,9238
0500000US45077,45077,"Pickens County, South Carolina",46428,38509,296,33163,5050,7919
0500000US45079,45079,"Richland County, South Carolina",149161,134173,555,114538,19080,14988
0500000US45081,45081,"Saluda County, South Carolina",7052,4832,57,3880,895,2220
0500000US45083,45083,"Spartanburg County, South Carolina",113191,95277,542,83043,11692,17914
0500000US45085,45085,"Sumter County, South Carolina",41417,33804,364,28645,4795,7613
0500000US45087,45087,"Union County, South Carolina",11564,8286,75,6520,1691,3278
0500000US45089,45089,"Williamsburg County, South Carolina",12310,8095,103,5555,2437,4215
0500000US45091,45091,"York County, South Carolina",95539,85610,385,75969,9256,9929
0500000US46003,46003,"Aurora County, South Dakota",1179,914,9,812,93,265
0500000US46005,46005,"Beadle County, South Dakota",7651,6362,91,5216,1055,1289
0500000US46007,46007,"Bennett County, South Dakota",955,724,10,588,126,231
0500000US46009,46009,"Bon Homme County, South Dakota",2554,2074,22,1750,302,480
0500000US46011,46011,"Brookings County, South Dakota",12602,11623,71,10092,1460,979
0500000US46013,46013,"Brown County, South Dakota",16328,13648,73,12215,1360,2680
0500000US46015,46015,"Brule County, South Dakota",2170,1662,24,1445,193,508
0500000US46017,46017,"Buffalo County, South Dakota",530,331,4,256,71,199
0500000US46019,46019,"Butte County, South Dakota",4172,3484,15,3111,358,688
0500000US46021,46021,"Campbell County, South Dakota",690,528,2,474,52,162
0500000US46023,46023,"Charles Mix County, South Dakota",3184,2248,40,1802,406,936
0500000US46025,46025,"Clark County, South Dakota",1510,1147,45,935,167,363
0500000US46027,46027,"Clay County, South Dakota",5302,4894,4,4478,412,408
0500000US46029,46029,"Codington County, South Dakota",12011,10362,116,8788,1458,1649
0500000US46031,46031,"Corson County, South Dakota",1239,741,2,647,92,498
0500000US46033,46033,"Custer County, South Dakota",3901,3426,94,2891,441,475
0500000US46035,46035,"Davison County, South Dakota",8696,7406,26,6850,530,1290
0500000US46037,46037,"Day County, South Dakota",2567,2039,37,1551,451,528
0500000US46039,46039,"Deuel County, South Dakota",1835,1505,66,1272,167,330
0500000US46041,46041,"Dewey County, South Dakota",1648,964,3,840,121,684
0500000US46043,46043,"Douglas County, South Dakota",1271,1007,5,837,165,264
0500000US46045,46045,"Edmunds County, South Dakota",1579,1320,4,1114,202,259
0500000US46047,46047,"Fall River County, South Dakota",3115,2587,33,2335,219,528
0500000US46049,46049,"Faulk County, South Dakota",944,680,8,590,82,264
0500000US46051,46051,"Grant County, South Dakota",3203,2664,49,2400,215,539
0500000US46053,46053,"Gregory County, South Dakota",1943,1440,10,1224,206,503
0500000US46055,46055,"Haakon County, South Dakota",893,662,6,516,140,231
0500000US46057,46057,"Hamlin County, South Dakota",2193,1960,42,1522,396,233
0500000US46059,46059,"Hand County, South Dakota",1498,1185,6,1025,154,313
0500000US46061,46061,"Hanson County, South Dakota",1061,922,12,851,59,139
0500000US46063,46063,"Harding County, South Dakota",533,472,1,419,52,61
0500000US46065,46065,"Hughes County, South Dakota",7391,6084,18,5528,538,1307
0500000US46067,46067,"Hutchinson County, South Dakota",2881,2232,33,1878,321,649
0500000US46069,46069,"Hyde County, South Dakota",582,465,0,426,39,117
0500000US46071,46071,"Jackson County, South Dakota",984,632,3,498,131,352
0500000US46073,46073,"Jerauld County, South Dakota",911,747,15,643,89,164
0500000US46075,46075,"Jones County, South Dakota",405,347,5,293,49,58
0500000US46077,46077,"Kingsbury County, South Dakota",2327,1876,19,1560,297,451
0500000US46079,46079,"Lake County, South Dakota",4817,4158,18,3678,462,659
0500000US46081,46081,"Lawrence County, South Dakota",10902,9559,46,8566,947,1343
0500000US46083,46083,"Lincoln County, South Dakota",18736,17590,251,16373,966,1146
0500000US46085,46085,"Lyman County, South Dakota",1383,1116,4,928,184,267
0500000US46087,46087,"McCook County, South Dakota",2182,1909,26,1624,259,273
0500000US46089,46089,"McPherson County, South Dakota",1019,709,4,583,122,310
0500000US46091,46091,"Marshall County, South Dakota",1813,1548,38,1311,199,265
0500000US46093,46093,"Meade County, South Dakota",11022,9683,102,8714,867,1339
0500000US46095,46095,"Mellette County, South Dakota",683,407,3,278,126,276
0500000US46097,46097,"Miner County, South Dakota",990,813,11,720,82,177
0500000US46099,46099,"Minnehaha County, South Dakota",73762,65653,584,58261,6808,8109
0500000US46101,46101,"Moody County, South Dakota",2664,2255,17,1956,282,409
0500000US46102,46102,"Oglala Lakota County, South Dakota",2920,1634,20,1297,317,1286
0500000US46103,46103,"Pennington County, South Dakota",43110,37841,232,33767,3842,5269
0500000US46105,46105,"Perkins County, South Dakota",1311,1019,12,940,67,292
0500000US46107,46107,"Potter County, South Dakota",1025,869,20,743,106,156
0500000US46109,46109,"Roberts County, South Dakota",3756,2909,82,2395,432,847
0500000US46111,46111,"Sanborn County, South Dakota",1050,880,10,793,77,170
0500000US46115,46115,"Spink County, South Dakota",2626,2200,14,2008,178,426
0500000US46117,46117,"Stanley County, South Dakota",1309,1093,0,1066,27,216
0500000US46119,46119,"Sully County, South Dakota",601,482,1,446,35,119
0500000US46121,46121,"Todd County, South Dakota",2768,1718,13,1278,427,1050
0500000US46123,46123,"Tripp County, South Dakota",2424,1941,3,1668,270,483
0500000US46125,46125,"Turner County, South Dakota",3523,2825,27,2381,417,698
0500000US46127,46127,"Union County, South Dakota",6285,5467,52,4825,590,818
0500000US46129,46129,"Walworth County, South Dakota",2292,1684,10,1434,240,608
0500000US46135,46135,"Yankton County, South Dakota",9283,7766,85,6824,857,1517
0500000US46137,46137,"Ziebach County, South Dakota",764,431,5,352,74,333
0500000US47001,47001,"Anderson County, Tennessee",30518,24428,191,21590,2647,6090
0500000US47003,47003,"Bedford County, Tennessee",17058,14353,83,11524,2746,2705
0500000US47005,47005,"Benton County, Tennessee",6693,4953,89,3845,1019,1740
0500000US47007,47007,"Bledsoe County, Tennessee",4664,3395,32,2724,639,1269
0500000US47009,47009,"Blount County, Tennessee",49939,42518,252,36914,5352,7421
0500000US47011,47011,"Bradley County, Tennessee",39615,32412,284,28265,3863,7203
0500000US47013,47013,"Campbell County, Tennessee",15843,10780,90,8559,2131,5063
0500000US47015,47015,"Cannon County, Tennessee",5456,4377,83,3326,968,1079
0500000US47017,47017,"Carroll County, Tennessee",11321,8440,42,7375,1023,2881
0500000US47019,47019,"Carter County, Tennessee",23798,17636,496,14170,2970,6162
0500000US47021,47021,"Cheatham County, Tennessee",14671,12655,109,11181,1365,2016
0500000US47023,47023,"Chester County, Tennessee",5998,4826,61,4160,605,1172
0500000US47025,47025,"Claiborne County, Tennessee",12996,9140,130,7558,1452,3856
0500000US47027,47027,"Clay County, Tennessee",3171,2030,57,1603,370,1141
0500000US47029,47029,"Cocke County, Tennessee",14592,10417,130,7713,2574,4175
0500000US47031,47031,"Coffee County, Tennessee",21576,17989,61,14309,3619,3587
0500000US47033,47033,"Crockett County, Tennessee",5400,3939,26,3236,677,1461
0500000US47035,47035,"Cumberland County, Tennessee",25114,20517,248,17441,2828,4597
0500000US47037,47037,"Davidson County, Tennessee",273497,243627,873,214624,28130,29870
0500000US47039,47039,"Decatur County, Tennessee",4721,3664,54,2985,625,1057
0500000US47041,47041,"DeKalb County, Tennessee",7362,5534,89,4693,752,1828
0500000US47043,47043,"Dickson County, Tennessee",19032,14559,207,12504,1848,4473
0500000US47045,47045,"Dyer County, Tennessee",15327,12388,86,10888,1414,2939
0500000US47047,47047,"Fayette County, Tennessee",15084,12348,112,10487,1749,2736
0500000US47049,47049,"Fentress County, Tennessee",7385,5527,102,4591,834,1858
0500000US47051,47051,"Franklin County, Tennessee",16325,13163,163,10717,2283,3162
0500000US47053,47053,"Gibson County, Tennessee",19280,15246,180,12384,2682,4034
0500000US47055,47055,"Giles County, Tennessee",11599,9317,130,7184,2003,2282
0500000US47057,47057,"Grainger County, Tennessee",9112,7093,111,6092,890,2019
0500000US47059,47059,"Greene County, Tennessee",27319,20858,400,17450,3008,6461
0500000US47061,47061,"Grundy County, Tennessee",4894,3422,49,2883,490,1472
0500000US47063,47063,"Hamblen County, Tennessee",24343,19009,86,15692,3231,5334
0500000US47065,47065,"Hamilton County, Tennessee",139037,117035,382,104057,12596,22002
0500000US47067,47067,"Hancock County, Tennessee",2704,1704,21,1061,622,1000
0500000US47069,47069,"Hardeman County, Tennessee",8680,6189,73,4580,1536,2491
0500000US47071,47071,"Hardin County, Tennessee",10118,7639,133,6168,1338,2479
0500000US47073,47073,"Hawkins County, Tennessee",23375,17946,299,13660,3987,5429
0500000US47075,47075,"Haywood County, Tennessee",7104,4963,63,3803,1097,2141
0500000US47077,47077,"Henderson County, Tennessee",10827,8300,111,6701,1488,2527
0500000US47079,47079,"Henry County, Tennessee",13483,10746,26,8943,1777,2737
0500000US47081,47081,"Hickman County, Tennessee",8930,6038,93,4767,1178,2892
0500000US47083,47083,"Houston County, Tennessee",2999,2123,39,1830,254,876
0500000US47085,47085,"Humphreys County, Tennessee",7064,5122,55,4409,658,1942
0500000US47087,47087,"Jackson County, Tennessee",4566,3050,37,2679,334,1516
0500000US47089,47089,"Jefferson County, Tennessee",20088,16584,33,13713,2838,3504
0500000US47091,47091,"Johnson County, Tennessee",6936,4812,180,3804,828,2124
0500000US47093,47093,"Knox County, Tennessee",182315,159644,625,142036,16983,22671
0500000US47095,47095,"Lake County, Tennessee",2164,1495,14,1304,177,669
0500000US47097,47097,"Lauderdale County, Tennessee",9725,7309,47,5768,1494,2416
0500000US47099,47099,"Lawrence County, Tennessee",16101,12187,108,10038,2041,3914
0500000US47101,47101,"Lewis County, Tennessee",4663,3259,47,2578,634,1404
0500000US47103,47103,"Lincoln County, Tennessee",13653,10552,118,8238,2196,3101
0500000US47105,47105,"Loudon County, Tennessee",20090,17237,108,14985,2144,2853
0500000US47107,47107,"McMinn County, Tennessee",20352,15399,286,12972,2141,4953
0500000US47109,47109,"McNairy County, Tennessee",10095,7622,95,5965,1562,2473
0500000US47111,47111,"Macon County, Tennessee",9158,6667,70,5476,1121,2491
0500000US47113,47113,"Madison County, Tennessee",37110,30579,160,25560,4859,6531
0500000US47115,47115,"Marion County, Tennessee",11393,8734,45,7274,1415,2659
0500000US47117,47117,"Marshall County, Tennessee",12008,9875,89,8022,1764,2133
0500000US47119,47119,"Maury County, Tennessee",33332,28978,207,25420,3351,4354
0500000US47121,47121,"Meigs County, Tennessee",4818,3488,37,2757,694,1330
0500000US47123,47123,"Monroe County, Tennessee",17416,13138,144,11338,1656,4278
0500000US47125,47125,"Montgomery County, Tennessee",68904,61886,367,55308,6211,7018
0500000US47127,47127,"Moore County, Tennessee",2613,1988,52,1458,478,625
0500000US47129,47129,"Morgan County, Tennessee",7384,5614,92,4749,773,1770
0500000US47131,47131,"Obion County, Tennessee",12795,10235,64,8678,1493,2560
0500000US47133,47133,"Overton County, Tennessee",8937,6254,103,5334,817,2683
0500000US47135,47135,"Perry County, Tennessee",3295,2024,70,1705,249,1271
0500000US47137,47137,"Pickett County, Tennessee",2180,1509,14,1401,94,671
0500000US47139,47139,"Polk County, Tennessee",7023,5438,65,4447,926,1585
0500000US47141,47141,"Putnam County, Tennessee",30624,24144,223,20781,3140,6480
0500000US47143,47143,"Rhea County, Tennessee",12607,9659,35,7753,1871,2948
0500000US47145,47145,"Roane County, Tennessee",21619,17210,68,14749,2393,4409
0500000US47147,47147,"Robertson County, Tennessee",25065,21293,186,19155,1952,3772
0500000US47149,47149,"Rutherford County, Tennessee",106673,98181,336,85491,12354,8492
0500000US47151,47151,"Scott County, Tennessee",8519,6196,74,5094,1028,2323
0500000US47153,47153,"Sequatchie County, Tennessee",5505,4599,69,3800,730,906
0500000US47155,47155,"Sevier County, Tennessee",36901,30676,210,26554,3912,6225
0500000US47157,47157,"Shelby County, Tennessee",349207,287658,1498,243556,42604,61549
0500000US47159,47159,"Smith County, Tennessee",7535,5761,78,5016,667,1774
0500000US47161,47161,"Stewart County, Tennessee",5315,3934,29,3181,724,1381
0500000US47163,47163,"Sullivan County, Tennessee",66388,54633,279,47975,6379,11755
0500000US47165,47165,"Sumner County, Tennessee",64600,56857,368,51661,4828,7743
0500000US47167,47167,"Tipton County, Tennessee",21445,18146,214,15304,2628,3299
0500000US47169,47169,"Trousdale County, Tennessee",2944,2050,22,1691,337,894
0500000US47171,47171,"Unicoi County, Tennessee",7613,5787,131,4743,913,1826
0500000US47173,47173,"Union County, Tennessee",7268,5585,65,4199,1321,1683
0500000US47175,47175,"Van Buren County, Tennessee",2156,1559,43,1397,119,597
0500000US47177,47177,"Warren County, Tennessee",15755,11720,118,10417,1185,4035
0500000US47179,47179,"Washington County, Tennessee",52684,45216,373,40873,3970,7468
0500000US47181,47181,"Wayne County, Tennessee",5860,4128,138,3404,586,1732
0500000US47183,47183,"Weakley County, Tennessee",13607,10957,88,9342,1527,2650
0500000US47185,47185,"White County, Tennessee",9793,7144,63,6046,1035,2649
0500000US47187,47187,"Williamson County, Tennessee",73160,69373,173,65874,3326,3787
0500000US47189,47189,"Wilson County, Tennessee",47213,42186,227,38308,3651,5027
0500000US48001,48001,"Anderson County, Texas",16567,13141,105,10539,2497,3426
0500000US48003,48003,"Andrews County, Texas",5413,4769,16,4371,382,644
0500000US48005,48005,"Angelina County, Texas",30931,26726,319,23374,3033,4205
0500000US48007,48007,"Aransas County, Texas",9529,8309,97,7193,1019,1220
0500000US48009,48009,"Archer County, Texas",3351,2856,26,2323,507,495
0500000US48011,48011,"Armstrong County, Texas",702,618,10,507,101,84
0500000US48013,48013,"Atascosa County, Texas",15509,12992,74,11380,1538,2517
0500000US48015,48015,"Austin County, Texas",11021,9222,117,7686,1419,1799
0500000US48017,48017,"Bailey County, Texas",2230,1843,43,1260,540,387
0500000US48019,48019,"Bandera County, Texas",8278,7028,70,5859,1099,1250
0500000US48021,48021,"Bastrop County, Texas",26015,22665,122,19878,2665,3350
0500000US48023,48023,"Baylor County, Texas",1644,1363,0,1149,214,281
0500000US48025,48025,"Bee County, Texas",8531,7079,36,5291,1752,1452
0500000US48027,48027,"Bell County, Texas",116397,104792,435,91547,12810,11605
0500000US48029,48029,"Bexar County, Texas",627889,547933,2236,477026,68671,79956
0500000US48031,48031,"Blanco County, Texas",4230,3721,74,3255,392,509
0500000US48033,48033,"Borden County, Texas",248,224,0,189,35,24
0500000US48035,48035,"Bosque County, Texas",7027,5853,135,4703,1015,1174
0500000US48037,48037,"Bowie County, Texas",33171,25608,323,21750,3535,7563
0500000US48039,48039,"Brazoria County, Texas",117088,106441,518,94402,11521,10647
0500000US48041,48041,"Brazos County, Texas",77480,71015,111,60293,10611,6465
0500000US48043,48043,"Brewster County, Texas",3932,3190,22,2623,545,742
0500000US48045,48045,"Briscoe County, Texas",664,502,13,455,34,162
0500000US48047,48047,"Brooks County, Texas",2022,1361,5,1081,275,661
0500000US48049,48049,"Brown County, Texas",13835,10897,99,9415,1383,2938
0500000US48051,48051,"Burleson County, Texas",6565,4765,90,3968,707,1800
0500000US48053,48053,"Burnet County, Texas",16545,14464,85,11760,2619,2081
0500000US48055,48055,"Caldwell County, Texas",12894,10597,136,7691,2770,2297
0500000US48057,48057,"Calhoun County, Texas",7733,6791,14,5798,979,942
0500000US48059,48059,"Callahan County, Texas",5291,3720,151,3004,565,1571
0500000US48061,48061,"Cameron County, Texas",122188,89921,420,63643,25858,32267
0500000US48063,48063,"Camp County, Texas",4730,3600,39,2645,916,1130
0500000US48065,48065,"Carson County, Texas",2292,1982,27,1663,292,310
0500000US48067,48067,"Cass County, Texas",11811,8281,257,6556,1468,3530
0500000US48069,48069,"Castro County, Texas",2462,1963,52,1576,335,499
0500000US48071,48071,"Chambers County, Texas",13320,11500,146,10431,923,1820
0500000US48073,48073,"Cherokee County, Texas",17885,14362,180,11818,2364,3523
0500000US48075,48075,"Childress County, Texas",2282,1765,11,1520,234,517
0500000US48077,48077,"Clay County, Texas",4076,3339,10,2667,662,737
0500000US48079,48079,"Cochran County, Texas",1000,717,15,561,141,283
0500000US48081,48081,"Coke County, Texas",1574,1325,2,1035,288,249
0500000US48083,48083,"Coleman County, Texas",3470,2714,66,2157,491,756
0500000US48085,48085,"Collin County, Texas",323905,313010,731,291270,21009,10895
0500000US48087,48087,"Collingsworth County, Texas",1099,891,5,712,174,208
0500000US48089,48089,"Colorado County, Texas",7603,5939,49,4630,1260,1664
0500000US48091,48091,"Comal County, Texas",47253,43024,96,40101,2827,4229
0500000US48093,48093,"Comanche County, Texas",5107,3934,108,3027,799,1173
0500000US48095,48095,"Concho County, Texas",791,598,2,552,44,193
0500000US48097,48097,"Cooke County, Texas",15185,12810,24,10908,1878,2375
0500000US48099,48099,"Coryell County, Texas",22424,20146,83,18380,1683,2278
0500000US48101,48101,"Cottle County, Texas",664,472,7,392,73,192
0500000US48103,48103,"Crane County, Texas",1479,1292,7,1016,269,187
0500000US48105,48105,"Crockett County, Texas",1411,1106,0,912,194,305
0500000US48107,48107,"Crosby County, Texas",2064,1620,31,1241,348,444
0500000US48109,48109,"Culberson County, Texas",735,481,24,341,116,254
0500000US48111,48111,"Dallam County, Texas",2432,2025,0,1637,388,407
0500000US48113,48113,"Dallas County, Texas",906179,790521,3027,687830,99664,115658
0500000US48115,48115,"Dawson County, Texas",4339,3386,78,2622,686,953
0500000US48117,48117,"Deaf Smith County, Texas",6118,4835,28,4156,651,1283
0500000US48119,48119,"Delta County, Texas",2035,1643,24,1311,308,392
0500000US48121,48121,"Denton County, Texas",275164,263684,817,243713,19154,11480
0500000US48123,48123,"DeWitt County, Texas",7260,5158,71,4316,771,2102
0500000US48125,48125,"Dickens County, Texas",832,675,7,576,92,157
0500000US48127,48127,"Dimmit County, Texas",3476,2342,23,1976,343,1134
0500000US48129,48129,"Donley County, Texas",1230,907,10,710,187,323
0500000US48131,48131,"Duval County, Texas",3845,2496,21,2086,389,1349
0500000US48133,48133,"Eastland County, Texas",6437,4427,110,3660,657,2010
0500000US48135,48135,"Ector County, Texas",51475,44655,122,40702,3831,6820
0500000US48137,48137,"Edwards County, Texas",634,364,2,278,84,270
0500000US48139,48139,"Ellis County, Texas",54725,49803,291,44113,5399,4922
0500000US48141,48141,"El Paso County, Texas",263200,216668,1141,186083,29444,46532
0500000US48143,48143,"Erath County, Texas",13827,12316,47,9845,2424,1511
0500000US48145,48145,"Falls County, Texas",5405,3823,68,2893,862,1582
0500000US48147,48147,"Fannin County, Texas",12027,10110,173,8217,1720,1917
0500000US48149,48149,"Fayette County, Texas",9298,6884,254,5487,1143,2414
0500000US48151,48151,"Fisher County, Texas",1696,1316,20,1104,192,380
0500000US48153,48153,"Floyd County, Texas",2320,1863,37,1620,206,457
0500000US48155,48155,"Foard County, Texas",562,463,3,380,80,99
0500000US48157,48157,"Fort Bend County, Texas",222331,212633,790,201206,10637,9698
0500000US48159,48159,"Franklin County, Texas",3931,3247,22,2773,452,684
0500000US48161,48161,"Freestone County, Texas",7232,5784,69,4876,839,1448
0500000US48163,48163,"Frio County, Texas",4530,3108,26,2411,671,1422
0500000US48165,48165,"Gaines County, Texas",5716,4829,46,3872,911,887
0500000US48167,48167,"Galveston County, Texas",117455,104174,468,93762,9944,13281
0500000US48169,48169,"Garza County, Texas",1715,1365,0,1198,167,350
0500000US48171,48171,"Gillespie County, Texas",10795,9143,59,8183,901,1652
0500000US48173,48173,"Glasscock County, Texas",475,421,2,328,91,54
0500000US48175,48175,"Goliad County, Texas",2755,2109,44,1646,419,646
0500000US48177,48177,"Gonzales County, Texas",7018,5376,69,4644,663,1642
0500000US48179,48179,"Gray County, Texas",7971,6520,39,5337,1144,1451
0500000US48181,48181,"Grayson County, Texas",47550,40520,379,34373,5768,7030
0500000US48183,48183,"Gregg County, Texas",45615,38945,656,32501,5788,6670
0500000US48185,48185,"Grimes County, Texas",8980,7189,68,5833,1288,1791
0500000US48187,48187,"Guadalupe County, Texas",51990,46249,250,41519,4480,5741
0500000US48189,48189,"Hale County, Texas",11217,9139,80,8135,924,2078
0500000US48191,48191,"Hall County, Texas",1244,933,14,698,221,311
0500000US48193,48193,"Hamilton County, Texas",3157,2444,32,1939,473,713
0500000US48195,48195,"Hansford County, Texas",1924,1606,0,1322,284,318
0500000US48197,48197,"Hardeman County, Texas",1533,1227,4,974,249,306
0500000US48199,48199,"Hardin County, Texas",20739,17814,103,15571,2140,2925
0500000US48201,48201,"Harris County, Texas",1562813,1379566,5365,1215014,159187,183247
0500000US48203,48203,"Harrison County, Texas",23363,17543,194,14641,2708,5820
0500000US48205,48205,"Hartley County, Texas",1754,1511,3,1334,174,243
0500000US48207,48207,"Haskell County, Texas",2128,1509,2,1153,354,619
0500000US48209,48209,"Hays County, Texas",68045,63157,251,54577,8329,4888
0500000US48211,48211,"Hemphill County, Texas",1358,1222,0,974,248,136
0500000US48213,48213,"Henderson County, Texas",30459,23809,338,20134,3337,6650
0500000US48215,48215,"Hidalgo County, Texas",232523,188932,1313,143176,44443,43591
0500000US48217,48217,"Hill County, Texas",12674,10376,106,8620,1650,2298
0500000US48219,48219,"Hockley County, Texas",8065,6576,52,5659,865,1489
0500000US48221,48221,"Hood County, Texas",21527,19313,107,17378,1828,2214
0500000US48223,48223,"Hopkins County, Texas",13287,11177,151,9525,1501,2110
0500000US48225,48225,"Houston County, Texas",8328,6160,126,4427,1607,2168
0500000US48227,48227,"Howard County, Texas",11032,9058,57,7490,1511,1974
0500000US48229,48229,"Hudspeth County, Texas",890,580,35,380,165,310
0500000US48231,48231,"Hunt County, Texas",31781,26942,351,22109,4482,4839
0500000US48233,48233,"Hutchinson County, Texas",7799,6579,31,5749,799,1220
0500000US48235,48235,"Irion County, Texas",648,571,9,445,117,77
0500000US48237,48237,"Jack County, Texas",3075,2555,25,1971,559,520
0500000US48239,48239,"Jackson County, Texas",5232,4239,17,3358,864,993
0500000US48241,48241,"Jasper County, Texas",11974,9061,154,6176,2731,2913
0500000US48243,48243,"Jeff Davis County, Texas",1007,893,0,663,230,114
0500000US48245,48245,"Jefferson County, Texas",94020,73063,433,61416,11214,20957
0500000US48247,48247,"Jim Hogg County, Texas",1587,1012,22,762,228,575
0500000US48249,48249,"Jim Wells County, Texas",13614,8732,238,7159,1335,4882
0500000US48251,48251,"Johnson County, Texas",55467,49906,594,43696,5616,5561
0500000US48253,48253,"Jones County, Texas",5635,4642,92,3544,1006,993
0500000US48255,48255,"Karnes County, Texas",4303,2905,45,2354,506,1398
0500000US48257,48257,"Kaufman County, Texas",36525,31956,208,27174,4574,4569
0500000US48259,48259,"Kendall County, Texas",13691,12769,202,11299,1268,922
0500000US48261,48261,"Kenedy County, Texas",152,66,0,55,11,86
0500000US48263,48263,"Kent County, Texas",275,205,2,171,32,70
0500000US48265,48265,"Kerr County, Texas",20580,17210,275,15258,1677,3370
0500000US48267,48267,"Kimble County, Texas",1941,1504,6,1173,325,437
0500000US48269,48269,"King County, Texas",101,93,0,74,19,8
0500000US48271,48271,"Kinney County, Texas",1200,854,0,656,198,346
0500000US48273,48273,"Kleberg County, Texas",10958,9516,43,7967,1506,1442
0500000US48275,48275,"Knox County, Texas",1376,1088,3,918,167,288
0500000US48277,48277,"Lamar County, Texas",19085,15406,90,12353,2963,3679
0500000US48279,48279,"Lamb County, Texas",4790,3797,51,2891,855,993
0500000US48281,48281,"Lampasas County, Texas",7748,6616,120,5414,1082,1132
0500000US48283,48283,"La Salle County, Texas",2286,1551,0,1225,326,735
0500000US48285,48285,"Lavaca County, Texas",7684,5893,108,5298,487,1791
0500000US48287,48287,"Lee County, Texas",6118,5098,77,4255,766,1020
0500000US48289,48289,"Leon County, Texas",6245,5077,53,4415,609,1168
0500000US48291,48291,"Liberty County, Texas",25974,21235,230,18749,2256,4739
0500000US48293,48293,"Limestone County, Texas",8100,6169,46,4675,1448,1931
0500000US48295,48295,"Lipscomb County, Texas",1276,1102,8,1002,92,174
0500000US48297,48297,"Live Oak County, Texas",3586,2614,37,1956,621,972
0500000US48299,48299,"Llano County, Texas",8681,7334,69,6217,1048,1347
0500000US48301,48301,"Loving County, Texas",31,29,0,20,9,2
0500000US48303,48303,"Lubbock County, Texas",110275,97947,715,81921,15311,12328
0500000US48305,48305,"Lynn County, Texas",2147,1726,32,1372,322,421
0500000US48307,48307,"McCulloch County, Texas",3143,2518,16,2173,329,625
0500000US48309,48309,"McLennan County, Texas",88208,74837,570,61243,13024,13371
0500000US48311,48311,"McMullen County, Texas",194,129,0,102,27,65
0500000US48313,48313,"Madison County, Texas",4174,3292,34,2700,558,882
0500000US48315,48315,"Marion County, Texas",4457,3154,67,2475,612,1303
0500000US48317,48317,"Martin County, Texas",1635,1386,9,1042,335,249
0500000US48319,48319,"Mason County, Texas",1622,1221,11,939,271,401
0500000US48321,48321,"Matagorda County, Texas",13811,10611,138,8257,2216,3200
0500000US48323,48323,"Maverick County, Texas",16416,11840,21,8836,2983,4576
0500000US48325,48325,"Medina County, Texas",15154,12359,222,10356,1781,2795
0500000US48327,48327,"Menard County, Texas",964,675,8,530,137,289
0500000US48329,48329,"Midland County, Texas",55045,49827,95,44540,5192,5218
0500000US48331,48331,"Milam County, Texas",9437,7251,116,5756,1379,2186
0500000US48333,48333,"Mills County, Texas",1833,1469,21,1292,156,364
0500000US48335,48335,"Mitchell County, Texas",2639,2138,5,1620,513,501
0500000US48337,48337,"Montague County, Texas",8044,6672,45,5262,1365,1372
0500000US48339,48339,"Montgomery County, Texas",186861,172959,1117,158194,13648,13902
0500000US48341,48341,"Moore County, Texas",6725,5647,3,4871,773,1078
0500000US48343,48343,"Morris County, Texas",5024,3943,14,3563,366,1081
0500000US48345,48345,"Motley County, Texas",469,390,1,323,66,79
0500000US48347,48347,"Nacogdoches County, Texas",23825,20055,349,17249,2457,3770
0500000US48349,48349,"Navarro County, Texas",17326,14331,174,11481,2676,2995
0500000US48351,48351,"Newton County, Texas",4781,3592,124,2555,913,1189
0500000US48353,48353,"Nolan County, Texas",5552,4740,6,3714,1020,812
0500000US48355,48355,"Nueces County, Texas",128857,110416,272,97254,12890,18441
0500000US48357,48357,"Ochiltree County, Texas",3549,3118,27,2456,635,431
0500000US48359,48359,"Oldham County, Texas",581,494,4,436,54,87
0500000US48361,48361,"Orange County, Texas",32272,27300,120,23662,3518,4972
0500000US48363,48363,"Palo Pinto County, Texas",10441,8496,98,7053,1345,1945
0500000US48365,48365,"Panola County, Texas",9032,6869,121,5852,896,2163
0500000US48367,48367,"Parker County, Texas",43942,40083,318,35462,4303,3859
0500000US48369,48369,"Parmer County, Texas",3222,2487,37,1789,661,735
0500000US48371,48371,"Pecos County, Texas",4420,3263,13,2513,737,1157
0500000US48373,48373,"Polk County, Texas",17632,13673,258,10978,2437,3959
0500000US48375,48375,"Potter County, Texas",43453,35576,148,28741,6687,7877
0500000US48377,48377,"Presidio County, Texas",2589,1551,0,1116,435,1038
0500000US48379,48379,"Rains County, Texas",4333,3515,41,2902,572,818
0500000US48381,48381,"Randall County, Texas",49118,45135,270,40808,4057,3983
0500000US48383,48383,"Reagan County, Texas",1171,998,12,762,224,173
0500000US48385,48385,"Real County, Texas",1123,899,7,668,224,224
0500000US48387,48387,"Red River County, Texas",5218,3766,67,3025,674,1452
0500000US48389,48389,"Reeves County, Texas",3731,2717,82,1937,698,1014
0500000US48391,48391,"Refugio County, Texas",2694,2071,44,1730,297,623
0500000US48393,48393,"Roberts County, Texas",326,299,0,272,27,27
0500000US48395,48395,"Robertson County, Texas",6298,5146,26,4397,723,1152
0500000US48397,48397,"Rockwall County, Texas",30365,28909,111,27002,1796,1456
0500000US48399,48399,"Runnels County, Texas",3781,2887,35,2388,464,894
0500000US48401,48401,"Rusk County, Texas",17982,14155,344,10587,3224,3827
0500000US48403,48403,"Sabine County, Texas",3811,3107,52,2577,478,704
0500000US48405,48405,"San Augustine County, Texas",3202,2131,24,1777,330,1071
0500000US48407,48407,"San Jacinto County, Texas",9414,7799,59,6488,1252,1615
0500000US48409,48409,"San Patricio County, Texas",23246,19993,60,15457,4476,3253
0500000US48411,48411,"San Saba County, Texas",2135,1575,18,1323,234,560
0500000US48413,48413,"Schleicher County, Texas",1102,891,19,697,175,211
0500000US48415,48415,"Scurry County, Texas",5838,5096,42,4239,815,742
0500000US48417,48417,"Shackelford County, Texas",1257,940,2,811,127,317
0500000US48419,48419,"Shelby County, Texas",9218,6778,219,4992,1567,2440
0500000US48421,48421,"Sherman County, Texas",1063,906,3,790,113,157
0500000US48423,48423,"Smith County, Texas",77801,67924,298,59565,8061,9877
0500000US48425,48425,"Somervell County, Texas",3234,2780,6,2083,691,454
0500000US48427,48427,"Starr County, Texas",16320,12149,97,7885,4167,4171
0500000US48429,48429,"Stephens County, Texas",3361,2584,27,2095,462,777
0500000US48431,48431,"Sterling County, Texas",462,393,0,321,72,69
0500000US48433,48433,"Stonewall County, Texas",458,338,6,281,51,120
0500000US48435,48435,"Sutton County, Texas",1573,1182,0,869,313,391
0500000US48437,48437,"Swisher County, Texas",2602,2073,17,1823,233,529
0500000US48439,48439,"Tarrant County, Texas",689921,632606,4081,559828,68697,57315
0500000US48441,48441,"Taylor County, Texas",49443,43105,175,35053,7877,6338
0500000US48443,48443,"Terrell County, Texas",343,205,0,146,59,138
0500000US48445,48445,"Terry County, Texas",4142,3308,24,2593,691,834
0500000US48447,48447,"Throckmorton County, Texas",712,539,14,401,124,173
0500000US48449,48449,"Titus County, Texas",10675,8312,131,6850,1331,2363
0500000US48451,48451,"Tom Green County, Texas",43081,36182,162,31116,4904,6899
0500000US48453,48453,"Travis County, Texas",447561,416666,1231,377702,37733,30895
0500000US48455,48455,"Trinity County, Texas",5934,4567,127,3318,1122,1367
0500000US48457,48457,"Tyler County, Texas",7312,5719,43,4344,1332,1593
0500000US48459,48459,"Upshur County, Texas",14061,11550,248,9867,1435,2511
0500000US48461,48461,"Upton County, Texas",1308,1058,2,653,403,250
0500000US48463,48463,"Uvalde County, Texas",8624,6241,100,5269,872,2383
0500000US48465,48465,"Val Verde County, Texas",15189,11810,19,10192,1599,3379
0500000US48467,48467,"Van Zandt County, Texas",19354,15902,218,11828,3856,3452
0500000US48469,48469,"Victoria County, Texas",32734,27418,211,22240,4967,5316
0500000US48471,48471,"Walker County, Texas",21294,18939,152,15798,2989,2355
0500000US48473,48473,"Waller County, Texas",14698,12321,179,9435,2707,2377
0500000US48475,48475,"Ward County, Texas",3954,3147,30,2609,508,807
0500000US48477,48477,"Washington County, Texas",12205,9520,220,7304,1996,2685
0500000US48479,48479,"Webb County, Texas",72379,52527,431,41077,11019,19852
0500000US48481,48481,"Wharton County, Texas",15224,11876,254,9359,2263,3348
0500000US48483,48483,"Wheeler County, Texas",2287,1963,36,1579,348,324
0500000US48485,48485,"Wichita County, Texas",48528,41301,215,34603,6483,7227
0500000US48487,48487,"Wilbarger County, Texas",5155,4128,5,3448,675,1027
0500000US48489,48489,"Willacy County, Texas",5737,3900,49,2794,1057,1837
0500000US48491,48491,"Williamson County, Texas",170051,161372,521,151844,9007,8679
0500000US48493,48493,"Wilson County, Texas",15755,13713,220,12174,1319,2042
0500000US48495,48495,"Winkler County, Texas",2524,2041,27,1681,333,483
0500000US48497,48497,"Wise County, Texas",21691,19208,250,15589,3369,2483
0500000US48499,48499,"Wood County, Texas",16122,13450,246,11747,1457,2672
0500000US48501,48501,"Yoakum County, Texas",2652,2201,0,1768,433,451
0500000US48503,48503,"Young County, Texas",7066,5892,50,4834,1008,1174
0500000US48505,48505,"Zapata County, Texas",4457,3618,32,2389,1197,839
0500000US48507,48507,"Zavala County, Texas",3536,2294,23,1515,756,1242
0500000US49001,49001,"Beaver County, Utah",2313,1982,41,1738,203,331
0500000US49003,49003,"Box Elder County, Utah",17035,15179,161,13704,1314,1856
0500000US49005,49005,"Cache County, Utah",36829,34757,165,31002,3590,2072
0500000US49007,49007,"Carbon County, Utah",7841,6737,35,5856,846,1104
0500000US49009,49009,"Daggett County, Utah",168,166,0,152,14,2
0500000US49011,49011,"Davis County, Utah",101422,96723,658,89845,6220,4699
0500000US49013,49013,"Duchesne County, Utah",6650,5858,20,5310,528,792
0500000US49015,49015,"Emery County, Utah",3564,3071,18,2698,355,493
0500000US49017,49017,"Garfield County, Utah",1756,1574,23,1315,236,182
0500000US49019,49019,"Grand County, Utah",3873,3560,19,3095,446,313
0500000US49021,49021,"Iron County, Utah",15575,14397,80,12560,1757,1178
0500000US49023,49023,"Juab County, Utah",3287,2947,72,2534,341,340
0500000US49025,49025,"Kane County, Utah",2514,2232,21,1844,367,282
0500000US49027,49027,"Millard County, Utah",4235,3820,75,3333,412,415
0500000US49029,49029,"Morgan County, Utah",3236,3099,20,2971,108,137
0500000US49031,49031,"Piute County, Utah",516,431,12,361,58,85
0500000US49033,49033,"Rich County, Utah",601,559,25,431,103,42
0500000US49035,49035,"Salt Lake County, Utah",363058,339613,2253,300280,37080,23445
0500000US49037,49037,"San Juan County, Utah",4019,2540,76,1923,541,1479
0500000US49039,49039,"Sanpete County, Utah",8366,7440,92,6364,984,926
0500000US49041,49041,"Sevier County, Utah",7171,6382,69,5526,787,789
0500000US49043,49043,"Summit County, Utah",14781,14131,33,13417,681,650
0500000US49045,49045,"Tooele County, Utah",19562,18152,101,16977,1074,1410
0500000US49047,49047,"Uintah County, Utah",10616,9314,105,8395,814,1302
0500000US49049,49049,"Utah County, Utah",155664,150033,602,132627,16804,5631
0500000US49051,49051,"Wasatch County, Utah",9040,8591,76,7988,527,449
0500000US49053,49053,"Washington County, Utah",52385,48310,405,43341,4564,4075
0500000US49055,49055,"Wayne County, Utah",990,872,43,736,93,118
0500000US49057,49057,"Weber County, Utah",81298,74595,501,66141,7953,6703
0500000US50001,50001,"Addison County, Vermont",14701,12745,152,11448,1145,1956
0500000US50003,50003,"Bennington County, Vermont",15280,13351,182,11750,1419,1929
0500000US50005,50005,"Caledonia County, Vermont",12094,10018,204,8377,1437,2076
0500000US50007,50007,"Chittenden County, Vermont",64906,59968,424,54906,4638,4938
0500000US50009,50009,"Essex County, Vermont",2720,2082,50,1814,218,638
0500000US50011,50011,"Franklin County, Vermont",18649,15926,183,14361,1382,2723
0500000US50013,50013,"Grand Isle County, Vermont",2952,2683,30,2381,272,269
0500000US50015,50015,"Lamoille County, Vermont",10401,9230,145,8128,957,1171
0500000US50017,50017,"Orange County, Vermont",12275,10419,291,8975,1153,1856
0500000US50019,50019,"Orleans County, Vermont",11498,9241,125,8115,1001,2257
0500000US50021,50021,"Rutland County, Vermont",25160,21527,142,18902,2483,3633
0500000US50023,50023,"Washington County, Vermont",24719,21474,136,19514,1824,3245
0500000US50025,50025,"Windham County, Vermont",19059,16751,291,14194,2266,2308
0500000US50027,50027,"Windsor County, Vermont",24121,21143,188,19032,1923,2978
0500000US51001,51001,"Accomack County, Virginia",13528,10510,115,8351,2044,3018
0500000US51003,51003,"Albemarle County, Virginia",40015,36516,313,32912,3291,3499
0500000US51005,51005,"Alleghany County, Virginia",6866,5288,73,4402,813,1578
0500000US51007,51007,"Amelia County, Virginia",4699,3923,73,3245,605,776
0500000US51009,51009,"Amherst County, Virginia",12110,9112,230,7274,1608,2998
0500000US51011,51011,"Appomattox County, Virginia",5948,4478,77,3503,898,1470
0500000US51013,51013,"Arlington County, Virginia",102310,97071,499,91642,4930,5239
0500000US51015,51015,"Augusta County, Virginia",28790,23381,210,19920,3251,5409
0500000US51017,51017,"Bath County, Virginia",1847,1441,110,1127,204,406
0500000US51019,51019,"Bedford County, Virginia",30927,25611,373,21871,3367,5316
0500000US51021,51021,"Bland County, Virginia",2561,2081,25,1688,368,480
0500000US51023,51023,"Botetourt County, Virginia",13238,11390,82,9928,1380,1848
0500000US51025,51025,"Brunswick County, Virginia",6048,4440,57,3395,988,1608
0500000US51027,51027,"Buchanan County, Virginia",9022,6155,185,5119,851,2867
0500000US51029,51029,"Buckingham County, Virginia",5705,4441,140,3256,1045,1264
0500000US51031,51031,"Campbell County, Virginia",22608,18182,375,15497,2310,4426
0500000US51033,51033,"Caroline County, Virginia",10815,8903,217,7141,1545,1912
0500000US51035,51035,"Carroll County, Virginia",12517,9144,87,7695,1362,3373
0500000US51036,51036,"Charles City County, Virginia",2899,2099,62,1566,471,800
0500000US51037,51037,"Charlotte County, Virginia",4493,2900,154,2219,527,1593
0500000US51041,51041,"Chesterfield County, Virginia",120907,111913,410,104882,6621,8994
0500000US51043,51043,"Clarke County, Virginia",5568,4677,43,3933,701,891
0500000US51045,51045,"Craig County, Virginia",2344,1721,53,1413,255,623
0500000US51047,51047,"Culpeper County, Virginia",16837,14491,275,12840,1376,2346
0500000US51049,51049,"Cumberland County, Virginia",3972,3104,32,2116,956,868
0500000US51051,51051,"Dickenson County, Virginia",6096,4348,167,3365,816,1748
0500000US51053,51053,"Dinwiddie County, Virginia",10347,8526,154,6996,1376,1821
0500000US51057,51057,"Essex County, Virginia",4470,3295,81,2412,802,1175
0500000US51059,51059,"Fairfax County, Virginia",393380,378532,1292,361036,16204,14848
0500000US51061,51061,"Fauquier County, Virginia",23981,21734,224,19889,1621,2247
0500000US51063,51063,"Floyd County, Virginia",6434,4854,94,4266,494,1580
0500000US51065,51065,"Fluvanna County, Virginia",9794,8856,69,7984,803,938
0500000US51067,51067,"Franklin County, Virginia",23203,18325,410,15250,2665,4878
0500000US51069,51069,"Frederick County, Virginia",30495,26830,232,22948,3650,3665
0500000US51071,51071,"Giles County, Virginia",7088,5461,129,4903,429,1627
0500000US51073,51073,"Gloucester County, Virginia",14746,12902,112,11665,1125,1844
0500000US51075,51075,"Goochland County, Virginia",8257,7347,101,6510,736,910
0500000US51077,51077,"Grayson County, Virginia",6653,4772,80,4038,654,1881
0500000US51079,51079,"Greene County, Virginia",7260,6417,45,5684,688,843
0500000US51081,51081,"Greensville County, Virginia",3649,2836,57,1929,850,813
0500000US51083,51083,"Halifax County, Virginia",14084,9376,234,7285,1857,4708
0500000US51085,51085,"Hanover County, Virginia",38208,34737,332,31607,2798,3471
0500000US51087,51087,"Henrico County, Virginia",126115,113882,462,104160,9260,12233
0500000US51089,51089,"Henry County, Virginia",22161,17439,267,14126,3046,4722
0500000US51091,51091,"Highland County, Virginia",1163,869,36,755,78,294
0500000US51093,51093,"Isle of Wight County, Virginia",14157,12120,122,10268,1730,2037
0500000US51095,51095,"James City County, Virginia",28410,26033,66,24113,1854,2377
0500000US51097,51097,"King and Queen County, Virginia",2811,1974,70,1447,457,837
0500000US51099,51099,"King George County, Virginia",8972,8216,78,7410,728,756
0500000US51101,51101,"King William County, Virginia",6079,5097,77,4017,1003,982
0500000US51103,51103,"Lancaster County, Virginia",5081,4130,71,3546,513,951
0500000US51105,51105,"Lee County, Virginia",9278,6434,187,4509,1738,2844
0500000US51107,51107,"Loudoun County, Virginia",121299,117198,320,112304,4574,4101
0500000US51109,51109,"Louisa County, Virginia",13451,11503,198,9602,1703,1948
0500000US51111,51111,"Lunenburg County, Virginia",4480,3000,138,2329,533,1480
0500000US51113,51113,"Madison County, Virginia",5107,4271,155,3407,709,836
0500000US51115,51115,"Mathews County, Virginia",3766,3252,107,2693,452,514
0500000US51117,51117,"Mecklenburg County, Virginia",11785,8198,289,6417,1492,3587
0500000US51119,51119,"Middlesex County, Virginia",4522,3601,42,2906,653,921
0500000US51121,51121,"Montgomery County, Virginia",35577,32186,118,29854,2214,3391
0500000US51125,51125,"Nelson County, Virginia",6523,5329,155,3877,1297,1194
0500000US51127,51127,"New Kent County, Virginia",7555,6899,223,5632,1044,656
0500000US51131,51131,"Northampton County, Virginia",5177,3906,44,3174,688,1271
0500000US51133,51133,"Northumberland County, Virginia",5774,4736,26,4028,682,1038
0500000US51135,51135,"Nottoway County, Virginia",5633,3934,23,3168,743,1699
0500000US51137,51137,"Orange County, Virginia",13470,11817,123,10007,1687,1653
0500000US51139,51139,"Page County, Virginia",9467,6943,158,5643,1142,2524
0500000US51141,51141,"Patrick County, Virginia",7713,5584,94,4645,845,2129
0500000US51143,51143,"Pittsylvania County, Virginia",26687,20298,339,16257,3702,6389
0500000US51145,51145,"Powhatan County, Virginia",9974,9230,150,8347,733,744
0500000US51147,51147,"Prince Edward County, Virginia",7281,5435,212,4467,756,1846
0500000US51149,51149,"Prince George County, Virginia",11298,10011,67,8805,1139,1287
0500000US51153,51153,"Prince William County, Virginia",139306,133800,335,127200,6265,5506
0500000US51155,51155,"Pulaski County, Virginia",14577,11484,193,9243,2048,3093
0500000US51157,51157,"Rappahannock County, Virginia",3131,2648,73,2197,378,483
0500000US51159,51159,"Richmond County, Virginia",3250,2429,33,1980,416,821
0500000US51161,51161,"Roanoke County, Virginia",38434,33915,111,30749,3055,4519
0500000US51163,51163,"Rockbridge County, Virginia",9160,6871,191,6006,674,2289
0500000US51165,51165,"Rockingham County, Virginia",30503,24666,307,21685,2674,5837
0500000US51167,51167,"Russell County, Virginia",11102,7687,130,6147,1410,3415
0500000US51169,51169,"Scott County, Virginia",8976,6296,78,5298,920,2680
0500000US51171,51171,"Shenandoah County, Virginia",17262,14052,143,12174,1735,3210
0500000US51173,51173,"Smyth County, Virginia",12829,9705,187,8142,1376,3124
0500000US51175,51175,"Southampton County, Virginia",6664,5390,137,4310,943,1274
0500000US51177,51177,"Spotsylvania County, Virginia",43279,40121,221,36963,2937,3158
0500000US51179,51179,"Stafford County, Virginia",45345,43321,106,41366,1849,2024
0500000US51181,51181,"Surry County, Virginia",2773,2304,63,1631,610,469
0500000US51183,51183,"Sussex County, Virginia",3388,2504,23,1990,491,884
0500000US51185,51185,"Tazewell County, Virginia",17330,13073,97,11546,1430,4257
0500000US51187,51187,"Warren County, Virginia",14190,12522,188,11029,1305,1668
0500000US51191,51191,"Washington County, Virginia",22388,17906,277,15677,1952,4482
0500000US51193,51193,"Westmoreland County, Virginia",7412,6002,50,5221,731,1410
0500000US51195,51195,"Wise County, Virginia",15104,11971,202,9697,2072,3133
0500000US51197,51197,"Wythe County, Virginia",11892,9002,69,7527,1406,2890
0500000US51199,51199,"York County, Virginia",24333,22916,80,21730,1106,1417
0500000US51510,51510,"Alexandria city, Virginia",68663,64976,131,60557,4288,3687
0500000US51520,51520,"Bristol city, Virginia",7418,5898,20,5196,682,1520
0500000US51530,51530,"Buena Vista city, Virginia",2606,1819,62,1542,215,787
0500000US51540,51540,"Charlottesville city, Virginia",18408,16540,75,14313,2152,1868
0500000US51550,51550,"Chesapeake city, Virginia",83031,76377,414,71334,4629,6654
0500000US51570,51570,"Colonial Heights city, Virginia",7092,5798,108,5035,655,1294
0500000US51580,51580,"Covington city, Virginia",2399,1715,36,1378,301,684
0500000US51590,51590,"Danville city, Virginia",18517,13918,123,11639,2156,4599
0500000US51595,51595,"Emporia city, Virginia",2119,1530,38,1179,313,589
0500000US51600,51600,"Fairfax city, Virginia",8499,8210,48,7842,320,289
0500000US51610,51610,"Falls Church city, Virginia",5308,5138,0,4821,317,170
0500000US51620,51620,"Franklin city, Virginia",3470,2806,4,2231,571,664
0500000US51630,51630,"Fredericksburg city, Virginia",10419,9440,27,8319,1094,979
0500000US51640,51640,"Galax city, Virginia",2837,2066,8,1756,302,771
0500000US51650,51650,"Hampton city, Virginia",53555,47830,286,41993,5551,5725
0500000US51660,51660,"Harrisonburg city, Virginia",16848,14828,54,12017,2757,2020
0500000US51670,51670,"Hopewell city, Virginia",9123,6678,84,5517,1077,2445
0500000US51678,51678,"Lexington city, Virginia",1935,1491,0,1264,227,444
0500000US51680,51680,"Lynchburg city, Virginia",28150,23370,158,19650,3562,4780
0500000US51683,51683,"Manassas city, Virginia",12540,11652,74,10800,778,888
0500000US51685,51685,"Manassas Park city, Virginia",4778,4565,0,4238,327,213
0500000US51690,51690,"Martinsville city, Virginia",5740,4415,18,3574,823,1325
0500000US51700,51700,"Newport News city, Virginia",68665,61026,290,52626,8110,7639
0500000US51710,51710,"Norfolk city, Virginia",87249,76973,247,68372,8354,10276
0500000US51720,51720,"Norton city, Virginia",1786,1458,7,1116,335,328
0500000US51730,51730,"Petersburg city, Virginia",13262,10213,91,7999,2123,3049
0500000US51735,51735,"Poquoson city, Virginia",4583,4163,0,3974,189,420
0500000US51740,51740,"Portsmouth city, Virginia",36616,30926,144,26689,4093,5690
0500000US51750,51750,"Radford city, Virginia",5503,4655,40,4117,498,848
0500000US51760,51760,"Richmond city, Virginia",89238,75103,516,62415,12172,14135
0500000US51770,51770,"Roanoke city, Virginia",42333,34970,292,29247,5431,7363
0500000US51775,51775,"Salem city, Virginia",9997,8708,21,7583,1104,1289
0500000US51790,51790,"Staunton city, Virginia",10477,8725,19,7504,1202,1752
0500000US51800,51800,"Suffolk city, Virginia",32331,28700,191,24743,3766,3631
0500000US51810,51810,"Virginia Beach city, Virginia",167731,157068,423,144465,12180,10663
0500000US51820,51820,"Waynesboro city, Virginia",9128,7428,20,6128,1280,1700
0500000US51830,51830,"Williamsburg city, Virginia",4649,4221,31,3799,391,428
0500000US51840,51840,"Winchester city, Virginia",10520,8521,60,7371,1090,1999
0500000US53001,53001,"Adams County, Washington",5824,4483,25,3593,865,1341
0500000US53003,53003,"Asotin County, Washington",9235,8089,119,7012,958,1146
0500000US53005,53005,"Benton County, Washington",70363,62759,614,55699,6446,7604
0500000US53007,53007,"Chelan County, Washington",27383,23944,216,19956,3772,3439
0500000US53009,53009,"Clallam County, Washington",32280,28081,380,25803,1898,4199
0500000US53011,53011,"Clark County, Washington",167717,156835,947,145103,10785,10882
0500000US53013,53013,"Columbia County, Washington",1759,1470,11,1334,125,289
0500000US53015,53015,"Cowlitz County, Washington",40668,35459,423,31379,3657,5209
0500000US53017,53017,"Douglas County, Washington",14706,13335,106,11370,1859,1371
0500000US53019,53019,"Ferry County, Washington",3056,2370,136,1834,400,686
0500000US53021,53021,"Franklin County, Washington",25835,21883,96,18712,3075,3952
0500000US53023,53023,"Garfield County, Washington",1007,877,9,727,141,130
0500000US53025,53025,"Grant County, Washington",30512,26046,223,22622,3201,4466
0500000US53027,53027,"Grays Harbor County, Washington",28070,23839,189,21803,1847,4231
0500000US53029,53029,"Island County, Washington",34027,31672,201,29501,1970,2355
0500000US53031,53031,"Jefferson County, Washington",13903,12514,148,11664,702,1389
0500000US53033,53033,"King County, Washington",851077,799885,2839,749852,47194,51192
0500000US53035,53035,"Kitsap County, Washington",100484,93721,440,88037,5244,6763
0500000US53037,53037,"Kittitas County, Washington",17648,16164,192,14270,1702,1484
0500000US53039,53039,"Klickitat County, Washington",8247,6958,179,5946,833,1289
0500000US53041,53041,"Lewis County, Washington",30036,25791,492,21967,3332,4245
0500000US53043,53043,"Lincoln County, Washington",4416,3929,123,3308,498,487
0500000US53045,53045,"Mason County, Washington",23034,20069,364,18061,1644,2965
0500000US53047,53047,"Okanogan County, Washington",17075,13803,277,11689,1837,3272
0500000US53049,53049,"Pacific County, Washington",8786,7344,83,6544,717,1442
0500000US53051,53051,"Pend Oreille County, Washington",5637,4827,90,3756,981,810
0500000US53053,53053,"Pierce County, Washington",312839,284784,1597,259531,23656,28055
0500000US53055,53055,"San Juan County, Washington",7718,7191,118,6411,662,527
0500000US53057,53057,"Skagit County, Washington",47341,42438,293,39098,3047,4903
0500000US53059,53059,"Skamania County, Washington",4713,3821,80,3342,399,892
0500000US53061,53061,"Snohomish County, Washington",284477,265149,1806,246553,16790,19328
0500000US53063,53063,"Spokane County, Washington",194995,175649,1724,160041,13884,19346
0500000US53065,53065,"Stevens County, Washington",17534,14585,353,12152,2080,2949
0500000US53067,53067,"Thurston County, Washington",106229,97080,516,89827,6737,9149
0500000US53069,53069,"Wahkiakum County, Washington",1823,1577,32,1397,148,246
0500000US53071,53071,"Walla Walla County, Washington",22391,19949,83,17753,2113,2442
0500000US53073,53073,"Whatcom County, Washington",83475,76064,488,70370,5206,7411
0500000US53075,53075,"Whitman County, Washington",17657,16536,118,14479,1939,1121
0500000US53077,53077,"Yakima County, Washington",81720,67950,722,58708,8520,13770
0500000US54001,54001,"Barbour County, West Virginia",6293,4974,81,4147,746,1319
0500000US54003,54003,"Berkeley County, West Virginia",42456,37227,392,32869,3966,5229
0500000US54005,54005,"Boone County, West Virginia",9298,7015,10,6421,584,2283
0500000US54007,54007,"Braxton County, West Virginia",5498,3797,67,3220,510,1701
0500000US54009,54009,"Brooke County, West Virginia",9961,8067,58,6645,1364,1894
0500000US54011,54011,"Cabell County, West Virginia",40239,33258,311,26743,6204,6981
0500000US54013,54013,"Calhoun County, West Virginia",2808,2089,45,1783,261,719
0500000US54015,54015,"Clay County, West Virginia",3365,2348,9,2075,264,1017
0500000US54017,54017,"Doddridge County, West Virginia",2662,2067,33,1630,404,595
0500000US54019,54019,"Fayette County, West Virginia",17697,13827,140,12189,1498,3870
0500000US54021,54021,"Gilmer County, West Virginia",2703,1983,27,1599,357,720
0500000US54023,54023,"Grant County, West Virginia",4372,2988,20,2792,176,1384
0500000US54025,54025,"Greenbrier County, West Virginia",15255,11697,117,10260,1320,3558
0500000US54027,54027,"Hampshire County, West Virginia",9676,5841,58,5197,586,3835
0500000US54029,54029,"Hancock County, West Virginia",12760,10192,16,8773,1403,2568
0500000US54031,54031,"Hardy County, West Virginia",5561,4314,32,3796,486,1247
0500000US54033,54033,"Harrison County, West Virginia",27542,22154,199,19901,2054,5388
0500000US54035,54035,"Jackson County, West Virginia",11149,8287,153,7027,1107,2862
0500000US54037,54037,"Jefferson County, West Virginia",20808,18719,100,16332,2287,2089
0500000US54039,54039,"Kanawha County, West Virginia",80267,67076,273,58977,7826,13191
0500000US54041,54041,"Lewis County, West Virginia",6586,5210,62,4383,765,1376
0500000US54043,54043,"Lincoln County, West Virginia",8046,6052,58,5492,502,1994
0500000US54045,54045,"Logan County, West Virginia",13978,10871,40,10013,818,3107
0500000US54047,54047,"McDowell County, West Virginia",7702,5295,48,4477,770,2407
0500000US54049,54049,"Marion County, West Virginia",22718,18611,132,16840,1639,4107
0500000US54051,54051,"Marshall County, West Virginia",12695,9990,46,8569,1375,2705
0500000US54053,54053,"Mason County, West Virginia",11079,8157,72,6882,1203,2922
0500000US54055,54055,"Mercer County, West Virginia",25019,19174,220,15944,3010,5845
0500000US54057,54057,"Mineral County, West Virginia",11274,7478,53,6862,563,3796
0500000US54059,54059,"Mingo County, West Virginia",10910,8152,51,7026,1075,2758
0500000US54061,54061,"Monongalia County, West Virginia",38410,34083,149,31213,2721,4327
0500000US54063,54063,"Monroe County, West Virginia",5815,4141,53,3323,765,1674
0500000US54065,54065,"Morgan County, West Virginia",7118,5895,140,5114,641,1223
0500000US54067,54067,"Nicholas County, West Virginia",10671,8456,87,7177,1192,2215
0500000US54069,54069,"Ohio County, West Virginia",17846,14272,116,11731,2425,3574
0500000US54071,54071,"Pendleton County, West Virginia",3032,2062,48,1676,338,970
0500000US54073,54073,"Pleasants County, West Virginia",2868,2379,38,2042,299,489
0500000US54075,54075,"Pocahontas County, West Virginia",3647,2664,31,2449,184,983
0500000US54077,54077,"Preston County, West Virginia",12420,10032,151,8851,1030,2388
0500000US54079,54079,"Putnam County, West Virginia",21734,18413,160,15577,2676,3321
0500000US54081,54081,"Raleigh County, West Virginia",31069,24699,92,22521,2086,6370
0500000US54083,54083,"Randolph County, West Virginia",11391,8381,93,7349,939,3010
0500000US54085,54085,"Ritchie County, West Virginia",3825,2818,50,2430,338,1007
0500000US54087,54087,"Roane County, West Virginia",5815,4211,82,3432,697,1604
0500000US54089,54089,"Summers County, West Virginia",5482,3991,17,2938,1036,1491
0500000US54091,54091,"Taylor County, West Virginia",6616,5072,29,4643,400,1544
0500000US54093,54093,"Tucker County, West Virginia",2951,2297,31,2064,202,654
0500000US54095,54095,"Tyler County, West Virginia",3563,2671,67,2262,342,892
0500000US54097,54097,"Upshur County, West Virginia",9341,7412,59,6381,972,1929
0500000US54099,54099,"Wayne County, West Virginia",16305,11968,107,10108,1753,4337
0500000US54101,54101,"Webster County, West Virginia",3690,2559,18,2350,191,1131
0500000US54103,54103,"Wetzel County, West Virginia",5979,4360,37,3808,515,1619
0500000US54105,54105,"Wirt County, West Virginia",2427,1942,16,1543,383,485
0500000US54107,54107,"Wood County, West Virginia",36110,30187,132,27300,2755,5923
0500000US54109,54109,"Wyoming County, West Virginia",9169,6585,34,5751,800,2584
0500000US55001,55001,"Adams County, Wisconsin",8163,6552,128,5585,839,1611
0500000US55003,55003,"Ashland County, Wisconsin",6504,5203,63,4436,704,1301
0500000US55005,55005,"Barron County, Wisconsin",19133,16089,171,14055,1863,3044
0500000US55007,55007,"Bayfield County, Wisconsin",6859,5858,95,5188,575,1001
0500000US55009,55009,"Brown County, Wisconsin",103267,91163,741,83122,7300,12104
0500000US55011,55011,"Buffalo County, Wisconsin",5723,4720,125,4199,396,1003
0500000US55013,55013,"Burnett County, Wisconsin",7284,5944,138,5061,745,1340
0500000US55015,55015,"Calumet County, Wisconsin",19345,17552,145,16250,1157,1793
0500000US55017,55017,"Chippewa County, Wisconsin",25247,21784,310,19492,1982,3463
0500000US55019,55019,"Clark County, Wisconsin",12755,9421,203,8147,1071,3334
0500000US55021,55021,"Columbia County, Wisconsin",23317,20064,260,17764,2040,3253
0500000US55023,55023,"Crawford County, Wisconsin",6610,5207,75,4502,630,1403
0500000US55025,55025,"Dane County, Wisconsin",216930,202568,1468,184602,16498,14362
0500000US55027,55027,"Dodge County, Wisconsin",33987,28418,429,25499,2490,5569
0500000US55029,55029,"Door County, Wisconsin",13159,11480,108,9962,1410,1679
0500000US55031,55031,"Douglas County, Wisconsin",18717,16177,329,13643,2205,2540
0500000US55033,55033,"Dunn County, Wisconsin",16652,14706,249,13048,1409,1946
0500000US55035,55035,"Eau Claire County, Wisconsin",40528,35733,212,32739,2782,4795
0500000US55037,55037,"Florence County, Wisconsin",1979,1662,22,1340,300,317
0500000US55039,55039,"Fond du Lac County, Wisconsin",41387,35490,477,31789,3224,5897
0500000US55041,55041,"Forest County, Wisconsin",4040,3151,61,2493,597,889
0500000US55043,55043,"Grant County, Wisconsin",19444,16075,310,14113,1652,3369
0500000US55045,55045,"Green County, Wisconsin",14957,12494,201,11045,1248,2463
0500000US55047,55047,"Green Lake County, Wisconsin",7932,6344,170,5443,731,1588
0500000US55049,55049,"Iowa County, Wisconsin",9799,8331,138,7441,752,1468
0500000US55051,55051,"Iron County, Wisconsin",2948,2414,71,2034,309,534
0500000US55053,55053,"Jackson County, Wisconsin",8154,6605,125,5720,760,1549
0500000US55055,55055,"Jefferson County, Wisconsin",32739,28339,326,25324,2689,4400
0500000US55057,55057,"Juneau County, Wisconsin",10149,8298,166,7114,1018,1851
0500000US55059,55059,"Kenosha County, Wisconsin",63286,55937,443,50196,5298,7349
0500000US55061,55061,"Kewaunee County, Wisconsin",8234,6853,135,5885,833,1381
0500000US55063,55063,"La Crosse County, Wisconsin",46966,41651,278,37960,3413,5315
0500000US55065,55065,"Lafayette County, Wisconsin",6714,5355,111,4707,537,1359
0500000US55067,55067,"Langlade County, Wisconsin",8646,6886,108,5977,801,1760
0500000US55069,55069,"Lincoln County, Wisconsin",12560,10426,178,8893,1355,2134
0500000US55071,55071,"Manitowoc County, Wisconsin",34119,28579,441,25045,3093,5540
0500000US55073,55073,"Marathon County, Wisconsin",54820,47055,635,42640,3780,7765
0500000US55075,55075,"Marinette County, Wisconsin",18548,15225,237,13338,1650,3323
0500000US55077,55077,"Marquette County, Wisconsin",6389,5150,111,4507,532,1239
0500000US55078,55078,"Menominee County, Wisconsin",1354,962,9,875,78,392
0500000US55079,55079,"Milwaukee County, Wisconsin",382027,319621,1980,279152,38489,62406
0500000US55081,55081,"Monroe County, Wisconsin",17832,14604,196,13051,1357,3228
0500000US55083,55083,"Oconto County, Wisconsin",15634,13109,193,11713,1203,2525
0500000US55085,55085,"Oneida County, Wisconsin",14994,12864,146,11559,1159,2130
0500000US55087,55087,"Outagamie County, Wisconsin",72288,64514,672,59347,4495,7774
0500000US55089,55089,"Ozaukee County, Wisconsin",35044,31876,210,29783,1883,3168
0500000US55091,55091,"Pepin County, Wisconsin",3005,2502,38,2305,159,503
0500000US55093,55093,"Pierce County, Wisconsin",15302,13423,210,11778,1435,1879
0500000US55095,55095,"Polk County, Wisconsin",18189,15350,306,13046,1998,2839
0500000US55097,55097,"Portage County, Wisconsin",28072,24750,188,22683,1879,3322
0500000US55099,55099,"Price County, Wisconsin",6567,5250,146,4551,553,1317
0500000US55101,55101,"Racine County, Wisconsin",75640,65058,491,58444,6123,10582
0500000US55103,55103,"Richland County, Wisconsin",7564,5944,117,5128,699,1620
0500000US55105,55105,"Rock County, Wisconsin",64482,55967,492,47625,7850,8515
0500000US55107,55107,"Rusk County, Wisconsin",6294,4963,115,4108,740,1331
0500000US55109,55109,"St. Croix County, Wisconsin",33389,30567,284,27739,2544,2822
0500000US55111,55111,"Sauk County, Wisconsin",25678,21679,320,19428,1931,3999
0500000US55113,55113,"Sawyer County, Wisconsin",7573,6194,91,5424,679,1379
0500000US55115,55115,"Shawano County, Wisconsin",17024,13672,233,12351,1088,3352
0500000US55117,55117,"Sheboygan County, Wisconsin",47532,41166,417,37513,3236,6366
0500000US55119,55119,"Taylor County, Wisconsin",8769,6730,180,5854,696,2039
0500000US55121,55121,"Trempealeau County, Wisconsin",11892,9503,124,8481,898,2389
0500000US55123,55123,"Vernon County, Wisconsin",12095,9217,164,8028,1025,2878
0500000US55125,55125,"Vilas County, Wisconsin",10758,8790,155,7360,1275,1968
0500000US55127,55127,"Walworth County, Wisconsin",40246,36002,422,31734,3846,4244
0500000US55129,55129,"Washburn County, Wisconsin",7142,5910,117,5101,692,1232
0500000US55131,55131,"Washington County, Wisconsin",53756,47773,382,44631,2760,5983
0500000US55133,55133,"Waukesha County, Wisconsin",156996,144379,857,136740,6782,12617
0500000US55135,55135,"Waupaca County, Wisconsin",21793,18113,333,15917,1863,3680
0500000US55137,55137,"Waushara County, Wisconsin",9851,7903,234,6756,913,1948
0500000US55139,55139,"Winnebago County, Wisconsin",69759,60730,626,54792,5312,9029
0500000US55141,55141,"Wood County, Wisconsin",32223,26431,286,24243,1902,5792
0500000US56001,56001,"Albany County, Wyoming",16009,15135,82,12830,2223,874
0500000US56003,56003,"Big Horn County, Wyoming",4481,3885,12,3212,661,596
0500000US56005,56005,"Campbell County, Wyoming",17588,16425,31,15165,1229,1163
0500000US56007,56007,"Carbon County, Wyoming",6205,5178,103,4476,599,1027
0500000US56009,56009,"Converse County, Wyoming",5630,5122,56,4290,776,508
0500000US56011,56011,"Crook County, Wyoming",3010,2709,40,2107,562,301
0500000US56013,56013,"Fremont County, Wyoming",15167,13060,74,10830,2156,2107
0500000US56015,56015,"Goshen County, Wyoming",5328,4361,44,3779,538,967
0500000US56017,56017,"Hot Springs County, Wyoming",2246,1911,39,1657,215,335
0500000US56019,56019,"Johnson County, Wyoming",3778,3006,35,2616,355,772
0500000US56021,56021,"Laramie County, Wyoming",38447,35170,225,31453,3492,3277
0500000US56023,56023,"Lincoln County, Wyoming",7063,6486,84,5378,1024,577
0500000US56025,56025,"Natrona County, Wyoming",32984,29312,142,25686,3484,3672
0500000US56027,56027,"Niobrara County, Wyoming",982,843,0,661,182,139
0500000US56029,56029,"Park County, Wyoming",11811,10686,152,9465,1069,1125
0500000US56031,56031,"Platte County, Wyoming",3740,3081,52,2559,470,659
0500000US56033,56033,"Sheridan County, Wyoming",13130,11277,45,10474,758,1853
0500000US56035,56035,"Sublette County, Wyoming",3197,3001,62,2650,289,196
0500000US56037,56037,"Sweetwater County, Wyoming",16269,14982,254,13319,1409,1287
0500000US56039,56039,"Teton County, Wyoming",8795,8391,40,7334,1017,404
0500000US56041,56041,"Uinta County, Wyoming",7705,7027,22,6384,621,678
0500000US56043,56043,"Washakie County, Wyoming",3490,3059,32,2658,369,431
0500000US56045,56045,"Weston County, Wyoming",3182,2637,15,2262,360,545